,shifted_percx_absolute,user_id,shifted_percy_absolute,measure_width_covered,measure_height_covered,movesleft,movesright,no_horizontal_movement,totalmovements_x,perc_left_movement,perc_right_movement,perc_no_movement_x,movesup,movesdown,no_vertical_movement,totalmovements_y,perc_upwward_movement,perc_downward_movement,perc_no_movement_y
0,2772.125,365,3744.7674418605284,27.72125,37.44767441860528,1427,1332,2245,5004,28.5171862509992,26.618705035971225,44.86410871302958,1512,2620,872,5004,30.215827338129497,52.35811350919265,17.42605915267786
1,1565.4074473826329,371,2256.4102564102454,15.654074473826329,22.564102564102456,1681,1557,805,4043,41.57803611179817,38.511006678209256,19.91095720999258,1327,1950,766,4043,32.822161761068514,48.231511254019296,18.946326984912194
2,3455.0512445095437,373,4327.609890109809,34.550512445095436,43.276098901098095,2347,2175,1429,5951,39.43874978995127,36.54847924718535,24.012770962863385,1719,2539,1693,5951,28.88590152915476,42.66509830280626,28.449000168038985
3,5897.364568082111,374,6338.186813186705,58.97364568082111,63.38186813186705,1829,1546,1599,4974,36.77121029352634,31.08162444712505,32.14716525934861,1626,2169,1179,4974,32.68998793727383,43.606755126658626,23.70325693606755
4,5423.572474377792,375,5956.1813186812915,54.23572474377792,59.56181318681291,1447,1459,998,3904,37.06454918032787,37.3719262295082,25.563524590163933,1718,1476,710,3904,44.00614754098361,37.80737704918033,18.186475409836063
5,3333.4375,376,3626.7647058823477,33.334375,36.26764705882348,904,903,405,2212,40.86799276672694,40.822784810126585,18.309222423146473,1026,749,437,2212,46.383363471971066,33.860759493670884,19.755877034358047
6,5763.396778916775,377,6192.276422764421,57.63396778916775,61.92276422764421,2221,2750,1738,6709,33.104784617677744,40.9897153077955,25.905500074526756,1904,3216,1589,6709,28.3797883440155,47.93560888358921,23.68460277239529
7,6025.695461200625,378,5508.333333333314,60.25695461200625,55.08333333333314,689,721,411,1821,37.83635365183965,39.593629873695775,22.57001647446458,749,659,413,1821,41.13124656781988,36.18890719384954,22.679846238330587
8,10817.1875,379,9135.094850948552,108.171875,91.35094850948552,2286,2446,2415,7147,31.985448439904857,34.224149993004055,33.79040156709109,2479,3409,1259,7147,34.685882188330766,47.69833496571989,17.615782845949347
9,4508.504398826957,382,4979.395604395608,45.085043988269575,49.79395604395608,639,636,390,1665,38.37837837837838,38.1981981981982,23.423423423423422,503,774,388,1665,30.21021021021021,46.48648648648649,23.303303303303302
10,7559.5168374821105,383,9882.142857142058,75.5951683748211,98.82142857142058,3507,3276,17412,24195,14.494730316181029,13.539987600743956,71.96528208307501,3939,6116,14140,24195,16.280223186608804,25.277949989667288,58.44182682372391
11,4838.286969253425,384,5345.467032966821,48.38286969253425,53.454670329668204,2539,2326,1967,6832,37.163348946135834,34.04566744730679,28.790983606557376,1630,3758,1444,6832,23.85831381733021,55.005854800936774,21.135831381733023
12,8512.152269399812,385,6642.994505494432,85.12152269399812,66.42994505494431,830,1336,773,2939,28.24089826471589,45.457638652602924,26.301463082681188,1167,1295,477,2939,39.707383463763186,44.06260632868322,16.230010207553587
13,14387.408491947368,386,19719.642857141203,143.8740849194737,197.19642857141204,6954,6829,70640,84423,8.237091787782951,8.089027871551592,83.67388034066546,5889,11391,67143,84423,6.975587221491773,13.492768558331262,79.53164422017697
14,5292.734375,388,5530.526315789205,52.92734375,55.30526315789205,2146,2698,1843,6687,32.09211903693734,40.34694182742635,27.56093913563631,2093,3079,1515,6687,31.29953641393749,46.04456407955735,22.655899506505158
15,2040.4375,390,2569.302325581401,20.404375,25.69302325581401,884,812,597,2293,38.55211513301352,35.41212385521151,26.035761011774966,820,989,484,2293,35.761011774967294,43.131269079808106,21.107719145224596
16,2708.4919472913807,392,3473.214285714275,27.084919472913807,34.73214285714275,790,833,368,1991,39.67855349070818,41.83827222501256,18.483174284279258,965,646,380,1991,48.468106479156205,32.446007031642395,19.085886489201407
17,4111.054172767253,393,5542.032967032731,41.110541727672526,55.42032967032731,3393,3123,2760,9276,36.57826649417852,33.667529107373866,29.75420439844761,2855,4380,2041,9276,30.778352738249243,47.21862871927555,22.003018542475207
18,10225.329428989917,395,11858.928571427421,102.25329428989917,118.58928571427421,4239,4464,17780,26483,16.006494732469886,16.856096363705017,67.13740890382509,5143,5380,15960,26483,19.42000528641015,20.314919004644487,60.26507570894536
19,23782.064421670326,396,20876.37362637388,237.82064421670327,208.7637362637388,6461,6978,42729,56168,11.502991026919242,12.423443953852727,76.07356501922803,8162,6489,41517,56168,14.531405782652044,11.552841475573281,73.91575274177468
20,7727.525622255057,397,6283.1044103414415,77.27525622255057,62.83104410341441,3939,3631,2206,9776,40.29255319148936,37.14198036006547,22.56546644844517,2750,3955,3071,9776,28.13011456628478,40.45621931260229,31.413666121112932
21,5652.734375,400,5876.315789473412,56.52734375,58.76315789473412,2603,2491,1868,6962,37.38868141338696,35.77994829072106,26.831370295891986,1991,3407,1564,6962,28.59810399310543,48.937087043952886,22.464808962941685
22,11663.762811127555,401,12992.719780218305,116.63762811127555,129.92719780218306,4347,5750,18658,28755,15.11737089201878,19.996522343940185,64.88610676404105,4017,7066,17672,28755,13.969744392279605,24.573117718657624,61.45713788906277
23,16564.421669107083,404,23243.956043958075,165.64421669107082,232.43956043958076,10826,11130,73659,95615,11.322491240914083,11.6404329864561,77.03707577262982,10331,14334,70950,95615,10.804790043403232,14.991371646708151,74.20383830988861
24,2309.736456808197,407,2276.648351648345,23.09736456808197,22.76648351648345,96,133,212,441,21.768707482993197,30.158730158730158,48.07256235827664,168,219,54,441,38.095238095238095,49.65986394557823,12.244897959183673
25,8508.199121523134,413,8693.681318680936,85.08199121523134,86.93681318680936,3022,2917,2536,8475,35.65781710914454,34.418879056047196,29.92330383480826,3018,3308,2149,8475,35.61061946902655,39.03244837758112,25.356932153392332
26,5550.68359375,415,5430.631868131606,55.5068359375,54.306318681316064,2258,2239,2404,6901,32.719895667294594,32.44457325025359,34.83553108245182,2002,3525,1374,6901,29.010288364005216,51.079553687871325,19.910157948123462
27,12315.959004392786,422,10436.950549449311,123.15959004392785,104.36950549449311,7569,8324,25242,41135,18.40038896317005,20.23580892184271,61.363802114987244,5339,7954,27842,41135,12.979214780600461,19.336331591102468,67.68445362829706
28,3906.442166910727,423,4744.917582417343,39.06442166910727,47.44917582417342,3190,3136,2639,8965,35.58282208588957,34.98047964305633,29.4366982710541,2272,4464,2229,8965,25.343000557724483,49.79364194088121,24.86335750139431
29,9341.800878477545,428,7587.804878049154,93.41800878477545,75.87804878049154,5312,5383,2596,13291,39.966894891279814,40.5010909638101,19.53201414491009,3299,4516,5476,13291,24.82130765179445,33.97787976826424,41.200812579941314
30,5754.245973645997,435,6721.978021977846,57.54245973645997,67.21978021977846,2931,3098,2701,8730,33.57388316151202,35.48682703321879,30.939289805269187,2873,4323,1534,8730,32.90950744558992,49.51890034364261,17.571592210767466
31,3439.0,438,4706.279069767628,34.39,47.062790697676284,2583,3256,3518,9357,27.605001603077913,34.797477824088915,37.59752057283317,3253,3922,2182,9357,34.76541626589719,41.91514374265256,23.31943999145025
32,3753.592375366539,441,4933.1043956043995,37.53592375366539,49.331043956044,865,890,729,2484,34.82286634460547,35.829307568438004,29.347826086956523,805,1067,612,2484,32.407407407407405,42.954911433172306,24.637681159420293
33,10537.48169838989,444,12375.274725272944,105.37481698389891,123.75274725272943,6735,6848,22124,35707,18.861847816954658,19.178312375724648,61.95983980732069,5429,7892,22386,35707,15.204301677542217,22.10210883020136,62.69358949225642
34,4104.895833333466,447,2298.4615384612575,41.04895833333466,22.984615384612574,6755,7650,4295,18700,36.12299465240641,40.909090909090914,22.967914438502675,3808,6194,8698,18700,20.363636363636363,33.12299465240642,46.51336898395722
35,5472.693997072123,448,5642.963980448947,54.72693997072123,56.42963980448947,4275,4557,3549,12381,34.528713351102496,36.80639689847347,28.664889750424038,2980,5368,4033,12381,24.069138195622326,43.356756320168,32.574105484209674
36,501.5,461,519.6511627906973,5.015,5.196511627906973,108,120,128,356,30.337078651685395,33.70786516853933,35.95505617977528,145,126,85,356,40.73033707865169,35.39325842696629,23.876404494382022
37,8274.6875,464,8691.395348837033,82.746875,86.91395348837034,3426,3620,3158,10204,33.5750686005488,35.47628381027048,30.948647589180712,3418,4599,2187,10204,33.49666797334378,45.070560564484516,21.432771462171697
38,7579.062957540982,465,7269.505494505057,75.79062957540982,72.69505494505057,3603,3783,2468,9854,36.56383194641769,38.39050131926121,25.045666734321088,2655,4981,2218,9854,26.943373249441848,50.54800081185306,22.508625938705094
39,3551.61054172766,471,5389.972527472223,35.5161054172766,53.89972527472223,2988,2187,3505,8680,34.42396313364055,25.195852534562214,40.38018433179724,2847,3923,1910,8680,32.79953917050691,45.19585253456221,22.004608294930875
40,5854.0625,481,5553.157894736589,58.540625,55.53157894736589,2370,1764,2043,6177,38.36813987372511,28.557552209810588,33.0743079164643,1718,3255,1204,6177,27.812854136312126,52.69548324429335,19.49166261939453
41,5073.352855051429,489,7163.461538461113,50.73352855051429,71.63461538461114,2820,2712,4575,10107,27.901454437518552,26.832888097358264,45.265657465123184,4123,3969,2015,10107,40.793509448896806,39.26981300089047,19.93667755021272
42,6529.140625,493,6344.117647059439,65.29140625,63.44117647059439,5264,5461,6682,17407,30.240707761245478,31.372436376170505,38.38685586258402,4864,7920,4623,17407,27.942781639570285,45.49893720916873,26.55828115126099
43,5103.221083455551,494,6896.614583333124,51.03221083455551,68.96614583333124,2696,2832,2954,8482,31.784956378212687,33.38835180381985,34.82669181796746,2532,4047,1903,8482,29.8514501296864,47.71280358406037,22.43574628625324
44,2992.093704245993,496,3436.9505494505474,29.920937042459933,34.369505494505475,931,867,483,2281,40.81543182814555,38.00964489259097,21.17492327926348,900,985,396,2281,39.4563787812363,43.182814555019725,17.360806663743972
45,4709.516837481849,500,4930.6318681317525,47.095168374818485,49.30631868131753,1873,1817,1495,5185,36.123432979749275,35.04339440694311,28.833172613307617,1961,2249,975,5185,37.82063645130183,43.37512054001928,18.80424300867888
46,4420.571010248937,501,3872.5274725274667,44.20571010248936,38.725274725274666,928,1044,465,2437,38.07960607304062,42.8395568321707,19.080837094788674,1044,927,466,2437,42.8395568321707,38.03857201477226,19.12187115305704
47,5713.9092240120535,504,6362.225274724944,57.13909224012053,63.62225274724944,4490,4581,2315,11386,39.43439311435096,40.233620235376776,20.331986650272263,3310,4314,3762,11386,29.070788687862287,37.88863516599332,33.04057614614439
48,7891.068814055793,505,7189.972527472447,78.91068814055794,71.89972527472447,1858,2122,1039,5019,37.01932655907551,42.279338513648135,20.70133492727635,2028,1995,996,5019,40.40645546921697,39.74895397489539,19.844590555887624
49,3481.7261904764373,507,5175.346534653599,34.81726190476437,51.75346534653599,3822,4273,4361,12456,30.684007707129098,34.304752729608225,35.011239563262684,3653,6160,2643,12456,29.32723185613359,49.454078355812456,21.21868978805395
50,4811.786237189162,517,5639.4230769227615,48.117862371891626,56.39423076922762,3317,3682,2417,9416,35.22727272727273,39.103653355989806,25.669073916737467,2857,4356,2203,9416,30.34197111299915,46.26168224299065,23.396346644010197
51,3490.9224011713163,519,3395.192307692307,34.909224011713164,33.95192307692307,600,717,283,1600,37.5,44.8125,17.6875,597,599,404,1600,37.3125,37.4375,25.25
52,2130.673499267947,521,2717.582417582419,21.30673499267947,27.17582417582419,611,714,360,1685,36.26112759643917,42.37388724035608,21.364985163204746,904,476,305,1685,53.64985163204747,28.24925816023739,18.100890207715135
53,4690.702781844869,522,5299.051490515013,46.90702781844869,52.99051490515013,1793,1818,1491,5102,35.14308114464916,35.63308506468052,29.223833790670323,1924,2191,987,5102,37.710701685613486,42.943943551548415,19.345354762838102
54,7236.749633968084,523,5747.252747252566,72.36749633968084,57.47252747252566,1705,1747,1191,4643,36.72194701701486,37.62653456816714,25.651518414818003,1170,2413,1060,4643,25.19922463924187,51.97070859358174,22.830066767176394
55,2822.986822840421,527,4070.604395604395,28.22986822840421,40.70604395604395,955,822,423,2200,43.40909090909091,37.36363636363637,19.227272727272727,1028,827,345,2200,46.72727272727273,37.59090909090909,15.681818181818183
56,6798.888888888883,530,34091.726094825,67.98888888888884,340.91726094825,129,155,2762,3046,4.235062376887722,5.088640840446487,90.67629678266579,1266,1556,224,3046,41.56270518713066,51.083388049901515,7.353906762967827
57,5527.15959004413,532,5622.527472527328,55.2715959004413,56.22527472527329,2008,2015,2051,6074,33.0589397431676,33.174185051037206,33.766875205795195,1772,3077,1225,6074,29.17352650642081,50.65854461639776,20.167928877181428
58,7993.333333333346,534,35966.21089677792,79.93333333333345,359.6621089677792,144,161,2367,2672,5.389221556886228,6.025449101796408,88.58532934131736,704,1711,257,2672,26.34730538922156,64.03443113772454,9.618263473053892
59,8368.359375000004,536,8351.57766826826,83.68359375000004,83.51577668268261,3182,3508,2545,9235,34.45587439090417,37.98592311857065,27.558202490525176,2564,3955,2716,9235,27.763941526800217,42.82620465619924,29.409853817000542
60,5662.884333821703,540,6778.846153845773,56.62884333821703,67.78846153845774,3881,4140,3565,11586,33.49732435698257,35.732780942516825,30.769894700500604,3776,4528,3282,11586,32.59105817365786,39.0816502675643,28.327291558777834
61,5004.5387994145485,542,6103.296703296498,50.045387994145486,61.03296703296498,2644,2485,2123,7252,36.45890788747931,34.26640926640926,29.274682846111418,2820,2833,1599,7252,38.88582460011031,39.06508549365692,22.049089906232762
62,8761.346998536095,546,8119.780219779889,87.61346998536095,81.1978021977989,2567,2630,2139,7336,34.99182115594329,35.85059978189749,29.15757906215922,3374,2338,1624,7336,45.99236641221374,31.87022900763359,22.137404580152673
63,10588.872620790882,549,6932.142857142354,105.88872620790882,69.32142857142354,6435,6580,3658,16673,38.595333773166196,39.465003298746474,21.939662928087326,4169,5097,7407,16673,25.00449829064955,30.570383254363342,44.42511845498711
64,4516.251830161224,550,3303.5087719298267,45.16251830161224,33.03508771929827,4874,4381,3094,12349,39.4687828974006,35.47655680621913,25.05466029638027,2375,3823,6151,12349,19.232326504170377,30.957972305449832,49.80970119037979
65,6607.027818448216,551,6401.510989010838,66.07027818448216,64.01510989010838,2407,2240,1977,6624,36.33756038647343,33.81642512077295,29.846014492753625,2380,2764,1480,6624,35.929951690821255,41.72705314009662,22.342995169082126
66,6240.702781845132,552,6079.268292683179,62.407027818451326,60.792682926831795,2654,2365,1943,6962,38.12122953174375,33.97012352772192,27.908646940534332,1561,4011,1390,6962,22.42171789715599,57.61275495547257,19.965527147371446
67,5348.3113069014125,557,6549.442896936343,53.483113069014124,65.49442896936343,3437,3552,2864,9853,34.88277681924287,36.04993403024459,29.067289150512533,3917,3533,2403,9853,39.75438952603268,35.85709936060083,24.388511113366487
68,1976.5104166666104,563,2424.134615384417,19.765104166666102,24.24134615384417,3677,3483,3201,10361,35.488852427371874,33.61644628896824,30.89470128365988,2246,5006,3109,10361,21.67744426213686,48.31579963324003,30.006756104623104
69,4560.922330097089,564,23721.66503422546,45.60922330097089,237.2166503422546,122,137,1404,1663,7.336139506915214,8.238123872519543,84.42573662056525,711,725,227,1663,42.754058929645225,43.595911004209256,13.650030066145522
70,6173.35285505129,565,3401.236263736259,61.7335285505129,34.01236263736259,473,599,410,1482,31.91632928475034,40.418353576248315,27.66531713900135,535,635,312,1482,36.09986504723347,42.847503373819166,21.052631578947366
71,11450.14641288453,570,7896.565934065627,114.50146412884529,78.96565934065626,3963,4588,3305,11856,33.42611336032389,38.69770580296896,27.876180836707153,3440,4824,3592,11856,29.01484480431849,40.688259109311744,30.296896086369767
72,7220.3513909227195,571,5005.906593406208,72.2035139092272,50.05906593406208,4415,4021,3056,11492,38.41802993386704,34.989557953358855,26.592412112774106,2874,4649,3969,11492,25.008701705534286,40.45422902888966,34.53706926557605
73,2553.5156249999923,573,3006.0692956939947,25.535156249999922,30.060692956939945,1119,1240,775,3134,35.705169112954685,39.56604977664327,24.728781110402043,1379,1215,540,3134,44.00127632418634,38.768347160178685,17.230376515634973
74,3998.169838945831,578,4936.538461538353,39.98169838945831,49.365384615383526,2368,2003,1605,5976,39.625167336010705,33.51740294511379,26.8574297188755,1816,2653,1507,5976,30.388219544846052,44.3942436412316,25.217536813922358
75,1617.3958333333187,579,2430.248091602936,16.173958333333186,24.302480916029356,2197,2624,2184,7005,31.3633119200571,37.45895788722341,31.177730192719487,1794,3606,1605,7005,25.610278372591004,51.477516059957175,22.91220556745182
76,10829.868228404113,584,7474.725274725252,108.29868228404113,74.74725274725252,484,409,362,1255,38.56573705179283,32.58964143426295,28.844621513944226,632,402,221,1255,50.3585657370518,32.03187250996016,17.60956175298805
77,7134.930555555095,591,6242.790697674471,71.34930555555096,62.42790697674471,4275,4021,2923,11219,38.10500044567252,35.84098404492379,26.054015509403687,2942,4612,3665,11219,26.22337106694001,41.10883322934308,32.667795703716905
78,1981.6145833331998,592,3101.3461538457695,19.816145833331998,31.013461538457694,5958,5723,5383,17064,34.91561181434599,33.53844350679794,31.54594467885607,4637,7612,4815,17064,27.1741678387248,44.608532583216125,28.217299578059073
79,7556.40625,594,9259.736842104743,75.5640625,92.59736842104743,2433,2882,1819,7134,34.10428931875526,40.398093636108776,25.497617045135968,1921,3653,1560,7134,26.92738996355481,51.20549481356883,21.867115222876365
80,4161.484375,595,54881.520119224944,41.61484375,548.8152011922494,218,223,4779,5220,4.176245210727969,4.272030651340996,91.55172413793103,1724,3242,254,5220,33.02681992337165,62.107279693486596,4.865900383141762
81,4246.852122986863,598,5528.319783197938,42.46852122986863,55.28319783197938,2091,2136,1877,6104,34.2562254259502,34.99344692005242,30.750327653997378,2117,2775,1212,6104,34.682175622542594,45.46199213630406,19.855832241153344
82,4469.999999999838,600,5417.093023255823,44.69999999999838,54.17093023255823,1957,2096,1898,5951,32.885229373214585,35.22097126533355,31.89379936145186,1585,3078,1288,5951,26.634179129558056,51.72239959670644,21.643421273735505
83,5658.956386292952,602,4072.2656250001423,56.589563862929516,40.72265625000142,4168,4149,1979,10296,40.48174048174048,40.2972027972028,19.22105672105672,3111,3747,3438,10296,30.215617715617714,36.392773892773896,33.39160839160839
84,7608.980582524276,604,35017.73890476944,76.08980582524276,350.17738904769436,171,162,3202,3535,4.837340876944837,4.582743988684583,90.57991513437058,1780,1493,262,3535,50.35360678925035,42.234794908062234,7.411598302687411
85,4643.777452416007,605,5170.054945054769,46.43777452416007,51.70054945054769,3412,3675,2337,9424,36.20543293718166,38.99617996604414,24.798387096774192,2334,4178,2912,9424,24.76655348047538,44.33361629881155,30.89983022071307
86,2245.0595238096,607,2998.8235294116903,22.450595238096,29.988235294116905,2661,2396,1947,7004,37.99257567104512,34.20902341519132,27.798400913763565,2268,3312,1424,7004,32.38149628783552,47.28726442033124,20.33123929183324
87,6969.18008784788,608,7056.504065040681,69.6918008784788,70.56504065040681,1999,2565,943,5507,36.2992554930089,46.57708371163973,17.12366079535137,1931,2296,1280,5507,35.06446341020519,41.692391501725076,23.24314508806973
88,4192.1875,612,6832.674418604839,41.921875,68.32674418604839,3705,3773,2938,10416,35.57027649769585,36.223118279569896,28.206605222734254,3454,4526,2436,10416,33.1605222734255,43.452380952380956,23.387096774193548
89,4612.8843338215465,614,5076.648351648154,46.12884333821547,50.76648351648154,2204,2511,2467,7182,30.687830687830687,34.962406015037594,34.349763297131716,1991,3447,1744,7182,27.72208298524088,47.99498746867168,24.282929546087438
90,9995.973645680782,616,9756.45604395511,99.95973645680782,97.5645604395511,1483,1608,3943,7034,21.08330963889679,22.860392379869207,56.056297981234,1680,4364,990,7034,23.883992038669323,62.04151265282911,14.074495308501564
91,2325.8333333333185,620,2428.173076922956,23.258333333333184,24.28173076922956,2532,2599,1849,6980,36.27507163323782,37.23495702005731,26.48997134670487,1907,3027,2046,6980,27.320916905444125,43.36676217765043,29.312320916905442
92,16743.3203125,621,8169.7857142851035,167.433203125,81.69785714285103,9626,9172,2714,21512,44.74711788769059,42.63666790628486,12.616214206024544,8569,8053,4890,21512,39.83358125697285,37.43492004462626,22.73149869840089
93,5410.375,624,6706.046511627975,54.10375,67.06046511627974,3107,3016,2173,8296,37.451783992285435,36.35486981677917,26.19334619093539,2324,3743,2229,8296,28.013500482160076,45.11812921890068,26.868370298939247
94,260.078125,627,274.307545367717,2.60078125,2.74307545367717,98,64,206,368,26.6304347826087,17.391304347826086,55.97826086956522,131,180,57,368,35.59782608695652,48.91304347826087,15.489130434782608
95,4805.4904831626145,628,5533.379120878904,48.054904831626146,55.333791208789044,2992,2791,2786,8569,34.91655969191271,32.5708950869413,32.51254522114599,2336,4307,1926,8569,27.261057299568208,50.26257439607888,22.4763683043529
96,26640.950540908496,630,31823.66519350219,266.40950540908494,318.2366519350219,19213,16019,301,35533,54.07086370416233,45.08203641685194,0.8470998789857316,15177,20338,18,35533,42.71240818394168,57.2369346804379,0.050657135620409195
97,13449.70703125,632,11562.22527472421,134.4970703125,115.62225274724209,3549,3603,2971,10123,35.05877704237874,35.592215746320264,29.349007211300997,3136,4416,2571,10123,30.978958806677863,43.62343178899536,25.397609404326783
98,4968.740849194928,633,6126.373626373261,49.687408491949284,61.26373626373261,4864,4816,3654,13334,36.478176091195444,36.11819409029549,27.403629818509074,4055,5469,3810,13334,30.410979451027448,41.015449227538625,28.573571321433928
99,4967.8125,639,5986.046511627934,49.678125,59.860465116279336,2437,1644,1561,5642,43.19390287132222,29.138603332151717,27.667493796526056,2117,2157,1368,5642,37.52215526409074,38.23112371499468,24.24672102091457
100,1058.888888888889,640,4161.718749999998,10.588888888888889,41.61718749999998,15,11,81,107,14.018691588785046,10.2803738317757,75.70093457943925,23,66,18,107,21.49532710280374,61.6822429906542,16.822429906542055
101,582.1933962264159,641,750.7797270955177,5.821933962264159,7.5077972709551775,236,279,1092,1607,14.685749844430616,17.361543248288736,67.95270690728064,272,443,892,1607,16.925948973242065,27.566894835096452,55.50715619166148
102,24167.27672035401,642,26537.50000000283,241.6727672035401,265.3750000000283,12030,11654,137225,160909,7.476275410325091,7.242602961922577,85.28112162775233,7984,16677,136248,160909,4.9618107128874085,10.364243143640193,84.6739461434724
103,7526.041666665925,645,9283.72093023229,75.26041666665925,92.8372093023229,5529,4770,17890,28189,19.6140338429884,16.921494199865194,63.46447195714641,4679,5623,17887,28189,16.598673241335273,19.94749725070063,63.4538295079641
104,9374.524158126269,646,12824.58791208649,93.74524158126269,128.2458791208649,6212,5109,21486,32807,18.934983387691652,15.572896028286646,65.4921205840217,5660,7004,20143,32807,17.25241564300302,21.34910232572317,61.398482031273815
105,30723.060029285498,647,29522.390109893102,307.230600292855,295.22390109893104,10089,9217,89197,108503,9.29836041399777,8.494695999188963,82.20694358681327,9767,11175,87561,108503,9.001594425960572,10.299254398495894,80.69915117554353
106,3738.2137628111536,649,5206.318681318462,37.382137628111536,52.06318681318462,2622,2272,2547,7441,35.2371993011692,30.533530439457063,34.22927025937374,2590,3431,1420,7441,34.80714957666981,46.10939389866953,19.083456524660665
107,10141.800878477487,652,12310.302197800826,101.41800878477487,123.10302197800826,4510,5939,17026,27475,16.414922656960872,21.616014558689717,61.969062784349404,3339,7455,16681,27475,12.152866242038217,27.133757961783438,60.71337579617835
108,8734.480234261011,654,11024.999999999005,87.34480234261011,110.24999999999005,3970,4341,15108,23419,16.9520474828131,18.53623126521201,64.51172125197489,3569,5375,14475,23419,15.239762585934496,22.951449677612196,61.80878773645331
109,2658.5294117647245,659,2742.857142857153,26.585294117647244,27.42857142857153,965,746,2516,4227,22.829429855689614,17.648450437662643,59.522119706647736,931,740,2556,4227,22.02507688668086,17.506505796072865,60.46841731724627
110,3308.7115666178825,662,3983.104395604319,33.087115666178825,39.83104395604319,2413,2250,2162,6825,35.35531135531135,32.967032967032964,31.677655677655675,1866,3311,1648,6825,27.34065934065934,48.51282051282052,24.14652014652015
111,12174.377745241545,664,10322.252747252101,121.74377745241546,103.22252747252101,2957,3055,2776,8788,33.648156577150665,34.76331360946745,31.588529813381882,2791,3784,2213,8788,31.759217114246702,43.058716431497494,25.182066454255803
112,8991.508052708952,667,8377.74725274671,89.91508052708951,83.77747252746711,4428,4443,17508,26379,16.786079836233366,16.842943250312747,66.37097691345389,2967,7233,16179,26379,11.247583304901626,27.419538269077677,61.3328784260207
113,11856.149341142087,673,11341.346153845207,118.56149341142087,113.41346153845207,4273,4974,16230,25477,16.77199042273423,19.523491776896808,63.70451780036896,3415,6250,15812,25477,13.404246967853359,24.53193076107862,62.06382227106803
114,8271.595900439466,679,8632.692307692014,82.71595900439466,86.32692307692014,1352,1943,5682,8977,15.060710705135346,21.644201849170102,63.295087445694556,1735,1985,5257,8977,19.327169432995433,22.1120641639746,58.56076640302996
115,6393.704245974006,680,7141.208791208496,63.93704245974006,71.41208791208496,4197,4294,3595,12086,34.72612940592421,35.528710905179544,29.745159688896244,3041,5311,3734,12086,25.16134370345855,43.943405593248386,30.895250703293065
116,9009.53125,683,10555.999999137814,90.0953125,105.55999999137813,3365,5460,18604,27429,12.268037478581064,19.905938969703598,67.82602355171534,4080,6896,16453,27429,14.874767581756535,25.141273834263007,59.98395858398046
117,17963.03074670624,685,18873.351648350887,179.6303074670624,188.73351648350888,7368,7741,48739,63848,11.539907279789501,12.124107254729983,76.33598546548052,6550,10260,47038,63848,10.258739506327528,16.069414860293197,73.67184563337928
118,4921.171875,686,5717.105263157419,49.21171875,57.17105263157419,3783,3669,3331,10783,35.08300102012427,34.02578132245201,30.891217657423724,2722,5835,2226,10783,25.243438746174533,54.112955578224984,20.643605675600483
119,6297.877013177653,690,7695.604395603955,62.97877013177653,76.95604395603955,4198,4549,2946,11693,35.901821602668264,38.903617548960916,25.194560848370823,3454,5444,2795,11693,29.53904045155221,46.557769605747026,23.903189942700763
120,9510.102489019211,691,8085.302197801922,95.10102489019211,80.85302197801923,4033,3664,10746,18443,21.8673751558857,19.86661606029388,58.266008783820425,3235,3260,11948,18443,17.540530282492004,17.67608306674619,64.78338665076181
121,8633.67647058837,700,7676.785714285516,86.33676470588371,76.76785714285516,3340,3411,2044,8795,37.97612279704378,38.783399658897096,23.240477544059125,2752,3898,2145,8795,31.290505969300742,44.320636725412164,24.388857305287097
122,9960.541727672397,704,11926.422764227402,99.60541727672397,119.26422764227402,4576,4374,16215,25165,18.183985694416847,17.38128352871051,64.43473077687264,4159,5501,15505,25165,16.52692231273594,21.85972580965627,61.61335187760779
123,4175.988286969302,717,4437.362637362589,41.75988286969302,44.373626373625896,2115,1947,1210,5272,40.11760242792109,36.9309559939302,22.95144157814871,1583,2513,1176,5272,30.026555386949926,47.66691957511381,22.306525037936268
124,12925.841874085083,718,11686.950549449126,129.25841874085083,116.86950549449126,4789,5878,19416,30083,15.919289964431737,19.539274673403582,64.54143536216468,4161,8066,17856,30083,13.831732207559085,26.812485456902568,59.35578233553834
125,7418.9604685216145,721,7465.934065933711,74.18960468521614,74.65934065933712,2859,3109,2160,8128,35.17470472440945,38.25049212598425,26.574803149606304,2473,3896,1759,8128,30.425688976377952,47.93307086614173,21.641240157480315
126,6629.8828125,726,7058.104395603961,66.298828125,70.58104395603961,2409,2668,3239,8316,28.968253968253972,32.082732082732086,38.94901394901395,1697,4923,1696,8316,20.406445406445407,59.19913419913419,20.394420394420397
127,11815.592972181688,727,12899.725274724005,118.15592972181689,128.99725274724005,4833,5430,17944,28207,17.13404474066721,19.25054064593895,63.61541461339384,3807,6488,17912,28207,13.496649767788139,23.001382635516006,63.50196759669585
128,3357.569444444321,728,4186.279069767574,33.57569444444321,41.862790697675734,2287,2041,1915,6243,36.633028992471566,32.69261572961717,30.674355277911257,2169,2457,1617,6243,34.74291206150889,39.35607880826525,25.901009130225855
129,6014.921875,740,5887.368421052269,60.14921875,58.87368421052269,2363,2909,1636,6908,34.206716850028954,42.11059640995947,23.68268674001158,1699,3763,1446,6908,24.594672843080488,54.47307469600463,20.93225246091488
130,10980.527086383741,749,12587.669376693411,109.8052708638374,125.87669376693411,4008,4504,15793,24305,16.490434067064392,18.53116642666118,64.97839950627443,3810,5639,14856,24305,15.675786875128574,23.200987451141742,61.123225673729685
131,0.0,750,inf,0.0,inf,0,0,0,0,,,,14,11,0,25,56.00000000000001,44.0,0.0
132,9846.19140625,752,9120.8604954369,98.4619140625,91.20860495436901,5949,4643,5389,15981,37.22545522808335,29.05325073524811,33.72129403666854,5544,6459,3978,15981,34.69119579500657,40.416744884550404,24.89205932044303
133,2976.573938506633,756,4290.796703296579,29.765739385066333,42.907967032965786,2739,2794,3158,8691,31.51536071798412,32.148199286618336,36.33643999539754,2901,3909,1881,8691,33.37935795650673,44.97756299620297,21.6430790472903
134,4641.434846266652,759,5359.065934065745,46.414348462666524,53.590659340657446,1562,2661,2312,6535,23.902065799540935,40.71920428462127,35.378729915837795,1856,3240,1439,6535,28.400918133129306,49.57918898240245,22.01989288446825
135,3092.3133235725027,760,4197.560975609829,30.923133235725025,41.975609756098294,2103,1795,1500,5398,38.958873656909965,33.253056687662095,27.78806965542794,1654,2341,1403,5398,30.64097814005187,43.367914042237864,25.99110781771026
136,26955.71010249273,764,16723.90109889792,269.5571010249273,167.2390109889792,13078,17994,42963,74035,17.664618086040388,24.30472074019045,58.03066117376916,9405,11698,52932,74035,12.703451070439655,15.800634834875396,71.49591409468495
137,3766.9838945827573,769,4444.917582417519,37.66983894582757,44.44917582417519,1960,2148,1715,5823,33.659625622531344,36.888201957753736,29.452172419714923,1812,2884,1127,5823,31.117980422462647,49.527734844581836,19.35428473295552
138,2314.94047619054,773,2972.4509803920955,23.149404761905398,29.724509803920956,2724,2405,1743,6872,39.639115250291034,34.99708963911525,25.363795110593713,2386,2790,1696,6872,34.72060535506402,40.599534342258444,24.679860302677533
139,3666.617862371933,774,4272.939560439397,36.66617862371933,42.729395604393964,3063,3425,1977,8465,36.18428824571766,40.460720614294154,23.354991139988186,1995,4635,1835,8465,23.567631423508566,54.75487300649734,21.677495569994093
140,5421.359223300974,775,27226.482302963333,54.21359223300974,272.26482302963336,153,182,2387,2722,5.6208670095518,6.686260102865541,87.69287288758267,945,1500,277,2722,34.71711976487877,55.10653930933137,10.17634092578986
141,5656.8081991217605,776,6627.197802197597,56.5680819912176,66.27197802197597,2586,2453,2135,7174,36.046835795929745,34.19291887371062,29.76024533035963,1923,3610,1641,7174,26.80512963479231,50.32060217451909,22.8742681906886
142,3602.9282576867026,777,4598.901098900998,36.029282576867026,45.98901098900998,2204,1714,1510,5428,40.604274134119386,31.577008106116434,27.818717759764183,1676,2354,1398,5428,30.87693441414886,43.36772291820192,25.755342667649227
143,4991.947291361856,778,4803.929539295542,49.919472913618556,48.03929539295542,1930,2230,1722,5882,32.81196871812308,37.91227473648419,29.275756545392724,1417,3254,1211,5882,24.090445426725605,55.32131927915675,20.588235294117645
144,6906.295754026752,780,6466.802168022023,69.06295754026752,64.66802168022022,2891,2981,1839,7711,37.49189469588899,38.65905848787447,23.849046816236548,1811,3899,2001,7711,23.48592919206329,50.564129166126314,25.949941641810405
145,4922.474377745413,783,5617.307692307482,49.22474377745413,56.173076923074824,2058,2294,2035,6387,32.22170032879286,35.91670580867387,31.861593862533272,1770,3254,1363,6387,27.71254109910756,50.94723657429153,21.34022232660091
146,4928.359375,785,4984.999999999789,49.28359375,49.84999999999789,2062,2102,1706,5870,35.12776831345826,35.80919931856899,29.063032367972742,1489,3078,1303,5870,25.36626916524702,52.43611584327087,22.197614991482112
147,5569.21875,786,6253.421052631005,55.6921875,62.534210526310055,4203,4244,2427,10874,38.65183005333824,39.02887621850285,22.31929372815891,2709,5359,2806,10874,24.91263564465698,49.28269266139415,25.804671693948865
148,3881.112737920951,791,5018.428184281895,38.81112737920951,50.18428184281895,1659,1641,1001,4301,38.57242501743781,38.153917693559634,23.273657289002557,1701,1852,748,4301,39.54894210648686,43.05975354568705,17.391304347826086
149,11841.027496381164,793,6481.830238726408,118.41027496381164,64.81830238726408,5995,6012,3545,15552,38.54809670781893,38.657407407407405,22.794495884773664,4145,5435,5972,15552,26.65252057613169,34.947273662551446,38.400205761316876
150,9013.909224012114,794,9775.274725274061,90.13909224012113,97.7527472527406,4572,3499,14300,22371,20.437173125921955,15.6407849447946,63.922041929283445,4174,4464,13733,22371,18.658084126771264,19.954405256805686,61.38751061642304
151,3244.4375,796,4301.162790697774,32.444375,43.011627906977736,2472,2580,15866,20918,11.81757338177646,12.333875131465723,75.84855148675783,2352,2888,15678,20918,11.243904771010612,13.806291232431397,74.94980399655799
152,5590.483162518611,797,6578.434065933685,55.904831625186105,65.78434065933685,2712,2412,2809,7933,34.186310349174335,30.404638850371864,35.4090508004538,2419,3756,1758,7933,30.49287785201059,47.34652716500693,22.160594982982477
153,11712.152269399881,798,11605.769230768188,117.12152269399881,116.05769230768188,4368,5020,15831,25219,17.32027439628851,19.905626710020222,62.77409889369127,3181,6607,15431,25219,12.613505690154248,26.198501130100322,61.187993179745426
154,3483.2357247437785,799,4841.327913279279,34.832357247437784,48.41327913279279,2043,2128,2142,6313,32.361793125297005,33.708221130999526,33.92998574370347,2238,2843,1232,6313,35.45065737367337,45.03405670837953,19.515285917947093
155,5209.590043923918,802,5731.868131868077,52.09590043923917,57.318681318680774,1656,2181,919,4756,34.81917577796468,45.857863751051305,19.32296047098402,1691,1935,1130,4756,35.55508830950379,40.68544995794785,23.75946173254836
156,15303.22265625,803,13024.587912087043,153.0322265625,130.24587912087043,3683,3966,13836,21485,17.14219222713521,18.459390272282988,64.3984175005818,3914,4828,12743,21485,18.21736094949965,22.471491738422156,59.31114731207819
157,3350.2083333333967,809,3347.467952874757,33.502083333333964,33.47467952874757,4179,3856,3268,11303,36.97248518092542,34.11483676899938,28.9126780500752,2536,4498,4269,11303,22.436521277536936,39.79474475802884,37.76873396443422
158,6775.475841874552,810,7504.258241758042,67.75475841874552,75.04258241758042,4379,4564,3490,12433,35.22078339901874,36.70875894796107,28.070457653020185,3836,5621,2976,12433,30.853374085096114,45.210327354620766,23.936298560283117
159,5024.6875,828,6059.044715447438,50.246875,60.590447154474376,4668,5150,20833,30651,15.22951942840364,16.802061922938893,67.96841864865748,3693,8607,18351,30651,12.048546540080258,28.08064989723011,59.87080356268963
160,8056.295754026829,839,9523.48901098823,80.56295754026829,95.23489010988231,3384,4063,14658,22105,15.308753675638995,18.38045691020131,66.31078941415969,3300,5367,13438,22105,14.928749151775616,24.279574756842344,60.791676091382044
161,6223.133235725069,849,6312.774725274253,62.23133235725069,63.12774725274253,4038,4159,3537,11734,34.41281745355377,35.44400886313277,30.143173683313446,2356,5058,4320,11734,20.078404636100224,43.10550536901312,36.81608999488665
162,6303.440702782157,852,5959.203296703082,63.03440702782157,59.59203296703082,2704,2610,1813,7127,37.94022730461625,36.62129928441139,25.438473410972357,2009,3702,1416,7127,28.188578644590994,51.9433141574295,19.868107197979516
163,5668.74084919501,854,7113.873626373298,56.6874084919501,71.13873626373298,3175,3182,2369,8726,36.38551455420582,36.465734586293834,27.148750859500343,2679,3952,2095,8726,30.70135228054091,45.28993811597525,24.00870960348384
164,4064.568081991285,862,4154.395604395481,40.64568081991285,41.543956043954815,3605,3367,2007,8979,40.149237108809444,37.498607862790955,22.352155028399597,2430,4305,2244,8979,27.063147343802207,47.94520547945205,24.99164717674574
165,9623.792093704396,863,10045.604395603634,96.23792093704397,100.45604395603634,3983,3186,2923,10092,39.46690447879509,31.56956004756243,28.963535473642487,3546,4262,2284,10092,35.13674197384067,42.23147047166072,22.631787554498615
166,8184.260614934648,865,7607.829670329254,81.84260614934648,76.07829670329255,3504,3660,2873,10037,34.91082992926173,36.46507920693434,28.624090863803925,3035,4864,2138,10037,30.23811895984856,48.460695426920395,21.301185613231045
167,5425.475841874331,866,8851.923076922298,54.254758418743315,88.51923076922297,3907,4042,22190,30139,12.963270181492417,13.411194797438537,73.62553502106904,3849,7056,19234,30139,12.770828494641496,23.411526593450347,63.817644911908154
168,10839.004149377488,867,41548.57142857144,108.39004149377487,415.48571428571444,3463,2366,3905,9734,35.576330388329566,24.30655434559277,40.11711526607767,3761,4993,980,9734,38.637764536675576,51.29443188822683,10.067803575097596
169,3162.890625,868,3353.048780487653,31.62890625,33.53048780487653,2884,2801,1982,7667,37.61575583670275,36.53319420894744,25.851049954349808,2769,3063,1835,7667,36.11582105125864,39.95043693752445,23.933742011216903
170,7117.423133236061,869,9179.670329669638,71.17423133236062,91.79670329669638,3729,4261,16055,24045,15.508421709295073,17.720939904346018,66.77063838635891,2964,6519,14562,24045,12.326887086712414,27.11166562694947,60.56144728633812
171,6012.59150805318,872,7343.406593406235,60.125915080531804,73.43406593406235,4951,3884,2822,11657,42.472334219782105,33.319035772497216,24.208630007720682,4046,4616,2995,11657,34.70875868576821,39.59852449172171,25.692716822510082
172,5763.5,875,6772.674418604751,57.635,67.72674418604751,3975,4619,2499,11093,35.83340845578293,41.63887136031732,22.527720183899756,3845,4239,3009,11093,34.661498242134684,38.213287658883985,27.12521409898134
173,34450.137236962,877,21307.708275069897,344.50137236962,213.07708275069896,2187,2110,7282,11579,18.88764141981173,18.22264444252526,62.88971413766301,2571,2360,6648,11579,22.20398998186372,20.381725537611192,57.41428448052509
174,2825.6954612005875,878,2446.016483516486,28.256954612005874,24.46016483516486,92,92,162,346,26.589595375722542,26.589595375722542,46.82080924855491,128,158,60,346,36.99421965317919,45.664739884393065,17.341040462427745
175,6943.045387994713,879,7553.983516482791,69.43045387994712,75.5398351648279,3138,3357,3708,10203,30.755660099970594,32.902087621287855,36.34225227874155,2907,4872,2424,10203,28.49162011173184,47.75066157012643,23.757718318141723
176,7128.257686676785,880,8421.721311476029,71.28257686676785,84.21721311476028,3957,4027,3027,11011,35.93679048224503,36.57251839070021,27.490691127054763,3935,4782,2294,11011,35.73699028244483,43.429297974752515,20.833711742802652
177,4601.640625,883,5772.763157894504,46.01640625,57.72763157894504,2287,2277,1800,6364,35.9365179132621,35.779384035197985,28.284098051539914,1957,3099,1308,6364,30.75109993714645,48.69578881206788,20.55311125078567
178,6225.183016105701,885,6960.714285713981,62.251830161057015,69.6071428571398,2770,2746,2131,7647,36.223355564273575,35.90950699620766,27.867137439518764,2332,3386,1929,7647,30.495619197070745,44.27880214463188,25.22557865829737
179,5858.308823530177,887,7195.192307691468,58.583088235301766,71.95192307691468,6104,7151,5878,19133,31.902994825693824,37.37521559609052,30.721789578215645,5180,6648,7305,19133,27.073642397951186,34.74624993466785,38.180107667380966
180,3859.0775988287173,890,3173.9010989011085,38.59077598828717,31.739010989011085,1417,1439,739,3595,39.41585535465925,40.02781641168289,20.556328233657858,1077,1568,950,3595,29.958275382475662,43.61613351877608,26.425591098748264
181,3691.4583333331725,891,4445.232558139681,36.91458333333173,44.452325581396806,3071,2025,1908,7004,43.84637350085666,28.912050256996004,27.241576242147342,1956,3984,1064,7004,27.926898914905767,56.88178183894917,15.19131924614506
182,383.1875,894,533.720930232558,3.831875,5.337209302325579,62,38,129,229,27.074235807860266,16.593886462882097,56.33187772925764,84,116,29,229,36.681222707423586,50.65502183406113,12.663755458515283
183,2808.9311859443605,897,2559.203296703293,28.089311859443605,25.592032967032928,97,125,172,394,24.61928934010152,31.725888324873097,43.65482233502538,161,160,73,394,40.86294416243655,40.609137055837564,18.527918781725887
184,2457.2916666666997,900,3409.0384615381704,24.572916666667,34.0903846153817,4006,4327,4427,12760,31.39498432601881,33.91065830721003,34.694357366771165,3331,5749,3680,12760,26.105015673981192,45.05485893416928,28.84012539184953
185,7058.333333333332,901,37090.697674418705,70.58333333333331,370.90697674418703,142,157,2020,2319,6.1233290211297975,6.770159551530833,87.10651142733937,997,1086,236,2319,42.99266925398879,46.830530401034935,10.176800344976284
186,710.1497504159732,904,2833.2125644419193,7.101497504159733,28.332125644419193,15,14,84,113,13.274336283185843,12.389380530973451,74.33628318584071,18,73,22,113,15.929203539823009,64.60176991150442,19.469026548672566
187,1816.875,909,1941.7682926828916,18.16875,19.417682926828917,1758,1807,1688,5253,33.466590519703026,34.39939082429088,32.13401865600609,1416,2716,1121,5253,26.956025128498002,51.70378831144108,21.340186560060918
188,15079.109062979996,912,13978.645833333552,150.79109062979995,139.78645833333553,5052,5825,3771,14648,34.489350081922446,39.76652102676133,25.74412889131622,4632,6199,3817,14648,31.62206444565811,42.319770617149096,26.05816493719279
189,8348.611111111119,922,39307.14285714319,83.48611111111119,393.0714285714319,150,168,2671,2989,5.018400802944129,5.620608899297424,89.36099029775845,959,1792,238,2989,32.08430913348946,59.95316159250586,7.962529274004685
190,7109.224011713287,923,7503.434065933846,71.09224011713287,75.03434065933845,2088,2301,2019,6408,32.58426966292135,35.90823970037454,31.507490636704123,2523,2772,1113,6408,39.37265917602996,43.258426966292134,17.368913857677903
191,5681.478770132114,931,5676.785714285409,56.81478770132114,56.76785714285409,3015,2485,2098,7598,39.68149513029744,32.70597525664648,27.61252961305607,2216,3232,2150,7598,29.16556988681232,42.53750987101869,28.296920242168994
192,5649.941037736222,932,6151.500938086772,56.49941037736222,61.515009380867724,3985,3820,13086,20891,19.075199846823992,18.285386051409695,62.63941410176631,3315,4616,12960,20891,15.868077162414437,22.09563927049926,62.0362835670863
193,11651.40625,934,9825.137362636497,116.5140625,98.25137362636497,4128,4182,2920,11230,36.7586821015138,37.23953695458593,26.001780943900265,2903,5261,3066,11230,25.850400712377557,46.847729296527156,27.30186999109528
194,4856.588579795253,935,5428.159340659099,48.56588579795253,54.28159340659099,3234,3211,2048,8493,38.07841752031084,37.8076062639821,24.11397621570705,2485,4202,1806,8493,29.259390085953136,49.47603909101613,21.26457082303073
195,5213.125,936,3431.7073170731114,52.13125,34.31707317073111,2013,2034,1092,5139,39.171044950379454,39.57968476357268,21.24927028604787,1961,1932,1246,5139,38.15917493675812,37.594862813777,24.245962249464874
196,10138.8125,938,6925.348837209295,101.388125,69.25348837209295,5750,6006,1884,13640,42.15542521994135,44.03225806451613,13.812316715542522,3673,4067,5900,13640,26.928152492668623,29.816715542521994,43.25513196480939
197,398.0468750000001,943,517.3786404063396,3.9804687500000013,5.173786404063396,30,98,31,159,18.867924528301888,61.63522012578616,19.49685534591195,84,49,26,159,52.83018867924528,30.81761006289308,16.352201257861633
198,26258.125915082408,946,12972.523655853987,262.58125915082405,129.72523655853988,8247,7437,5942,21626,38.13465273282161,34.38916119485804,27.476186072320356,7219,6357,8050,21626,33.38111532414686,29.39517247757329,37.22371219827985
199,5002.269399707447,949,4477.734375000262,50.02269399707447,44.77734375000262,8134,5736,6311,20181,40.30523759972251,28.422773896239033,31.27198850403845,4792,7042,8347,20181,23.745106783608342,34.89420742282345,41.36068579356821
200,20585.701275045376,953,11785.301297741189,205.85701275045375,117.8530129774119,3712,3512,4429,11653,31.854458079464514,30.138161846734747,38.00738007380074,3840,4627,3186,11653,32.95288766841157,39.70651334420321,27.340598987385224
201,10484.626647144903,955,9375.961538460826,104.84626647144904,93.75961538460825,3786,4132,3338,11256,33.63539445628998,36.70931058990761,29.655294953802418,3129,4948,3179,11256,27.798507462686565,43.958777540867096,28.242714996446338
202,5318.4027777775045,958,4785.175879397104,53.18402777777504,47.85175879397104,3605,3314,3360,10279,35.071505010215006,32.240490320070045,32.68800466971496,2279,3717,4283,10279,22.171417453059636,36.161105165872165,41.667477381068196
203,4900.146412884431,959,4869.505494505289,49.00146412884431,48.69505494505289,3800,4370,4076,12246,31.03054058468071,35.68512167238282,33.28433774293647,2334,5720,4192,12246,19.059284664380204,46.70912951167728,34.23158582394251
204,5680.875,962,6260.804597701517,56.80875,62.60804597701517,6555,7140,20212,33907,19.33229126728994,21.0575987259268,59.61011000678326,4075,7818,22014,33907,12.01816734007727,23.057185831834133,64.9246468280886
205,8545.27777777778,964,37249.05223806566,85.4527777777778,372.4905223806566,147,168,3899,4214,3.488372093023256,3.9867109634551494,92.52491694352159,2289,1685,240,4214,54.31893687707641,39.98576174655909,5.695301376364499
206,8048.490393412656,967,6026.041655325272,80.48490393412656,60.26041655325272,863,809,498,2170,39.76958525345622,37.28110599078341,22.94930875576037,944,863,363,2170,43.50230414746544,39.76958525345622,16.72811059907834
207,2276.1363636364426,968,3000.189393939771,22.761363636364425,30.00189393939771,4088,4910,5569,14567,28.0634310427679,33.70632250978238,38.230246447449716,4458,6705,3404,14567,30.603418686071254,46.02869499553786,23.367886318390884
208,8139.970717423798,970,9337.225274724618,81.39970717423799,93.37225274724618,4419,4698,3250,12367,35.73219050699442,37.98819438829142,26.27961510471416,4504,4912,2951,12367,36.419503517425404,39.718605967494135,23.861890515080457
209,14166.89453125,971,12533.203125000178,141.6689453125,125.33203125000178,5996,6224,39619,51839,11.566581145469627,12.00640444453018,76.4270144100002,6400,7335,38104,51839,12.34591716661201,14.149578502671734,73.50450433071626
210,7845.973645681226,972,8321.565934065533,78.45973645681227,83.21565934065534,4525,4691,2413,11629,38.91134233382062,40.33880815203371,20.749849514145673,2975,5284,3370,11629,25.582595236047812,45.438128815891304,28.979275948060884
211,3976.427525622289,974,4932.552083333299,39.76427525622289,49.325520833332995,3015,3377,2112,8504,35.45390404515522,39.7107243650047,24.835371589840076,2788,4301,1415,8504,32.78457196613358,50.57619943555973,16.63922859830668
212,5919.472913616704,982,6073.489010988695,59.19472913616704,60.73489010988695,2593,3137,2730,8460,30.650118203309695,37.08037825059102,32.269503546099294,2203,4255,2002,8460,26.04018912529551,50.29550827423168,23.664302600472816
213,20961.20058565238,989,22009.75274725316,209.61200585652378,220.0975274725316,5144,4593,32778,42515,12.099259085028812,10.803245913207103,77.09749500176409,4832,6342,31341,42515,11.365400446901095,14.917088086557687,73.71751146654123
214,64858.71156662532,990,48151.224005520846,648.5871156662532,481.51224005520845,17634,15265,207425,240324,7.337594247765517,6.351841680398129,86.31056407183635,16049,19305,204970,240324,6.678067941612157,8.032905577470414,85.28902648091743
215,5194.582723279797,993,6084.203296703118,51.945827232797974,60.84203296703118,2286,2423,2012,6721,34.01279571492337,36.0511828596935,29.93602142538313,3120,2131,1470,6721,46.42166344294004,31.706591281059364,21.871745276000595
216,3140.5625,994,3246.744186046528,31.405625,32.46744186046528,1156,870,401,2427,47.63081994231562,35.84672435105068,16.522455706633703,963,1006,458,2427,39.678615574783684,41.450350226617225,18.871034198599094
217,6743.265007320986,995,6094.917582417383,67.43265007320986,60.94917582417383,2466,2103,1559,6128,40.24151436031332,34.317885117493475,25.440600522193215,1319,3558,1251,6128,21.52415143603133,58.061357702349866,20.414490861618802
218,1012.79296875,997,842.411924119241,10.1279296875,8.42411924119241,397,435,276,1108,35.83032490974729,39.25992779783393,24.90974729241877,282,549,277,1108,25.451263537906136,49.54873646209386,25.0
219,6770.9375,999,7170.882352941222,67.709375,71.70882352941221,1392,1655,4356,7403,18.803187896798594,22.3558017020127,58.84101040118871,1713,1367,4323,7403,23.139267864379306,18.465486964744024,58.39524517087668
220,1994.1434846266527,1000,2571.840659340661,19.941434846266528,25.718406593406613,497,677,316,1490,33.355704697986575,45.43624161073826,21.20805369127517,708,536,246,1490,47.51677852348993,35.97315436241611,16.51006711409396
221,3594.729136163997,1001,4554.807692307683,35.94729136163997,45.548076923076835,1039,972,503,2514,41.32856006364359,38.66348448687351,20.007955449482896,1043,1086,385,2514,41.48766905330151,43.198090692124104,15.314240254574383
222,3813.0307467057296,1006,4177.994791666726,38.13030746705729,41.77994791666726,3076,3047,2462,8585,35.82993593476995,35.49213744903902,28.67792661619103,2126,3684,2775,8585,24.764123471170645,42.9120559114735,32.32382061735585
223,5475.763888888259,1007,5328.837209302506,54.757638888882596,53.28837209302506,5770,4683,3979,14432,39.980598669623056,32.44872505543237,27.570676274944567,3787,5760,4885,14432,26.240299334811528,39.91130820399113,33.84839246119734
224,3457.027818448041,1008,4336.401098900978,34.570278184480415,43.36401098900978,3065,3137,2542,8744,35.05260750228728,35.87602927721866,29.07136322049405,2486,4450,1808,8744,28.430924062214093,50.89204025617566,20.67703568161025
225,7022.474377745336,1011,7064.835164835112,70.22474377745336,70.64835164835112,1382,1464,3911,6757,20.452863696906913,21.66642000887968,57.88071629421341,1436,1276,4045,6757,21.25203492674264,18.88412017167382,59.86384490158354
226,6550.366032211081,1015,6490.109890109705,65.5036603221108,64.90109890109704,1985,2378,1713,6076,32.66951942067149,39.137590520079,28.192890059249503,2793,1940,1343,6076,45.96774193548387,31.92890059249506,22.103357472021067
227,10030.966325036745,1017,10340.109890109643,100.30966325036745,103.40109890109643,2456,2478,13542,18476,13.292920545572635,13.411993938081837,73.29508551634552,2438,2241,13797,18476,13.19549686079238,12.129248755141806,74.67525438406581
228,6742.166910688671,1019,6818.543956043465,67.42166910688671,68.18543956043465,3742,3790,3086,10618,35.24204181578452,35.6941043511019,29.06385383311358,3080,4056,3482,10618,29.00734601619891,38.19928423431908,32.79336974948201
229,3067.715959004401,1020,3254.3956043956077,30.677159590044013,32.54395604395608,738,806,403,1947,37.90446841294299,41.39702105803801,20.698510529019003,795,827,325,1947,40.83204930662558,42.475603492552644,16.69234720082178
230,9012.737920937378,1022,8649.58791208766,90.12737920937377,86.4958791208766,2939,2885,10121,15945,18.43211037942929,18.093446221386014,63.4744433991847,2557,3445,9943,15945,16.03637503919724,21.60551897146441,62.358105989338355
231,6565.080527086482,1024,5129.670329670299,65.65080527086482,51.29670329670299,1488,1400,559,3447,43.16797214969539,40.61502756019728,16.21700029010734,1076,1540,831,3447,31.215549753408762,44.676530316217,24.107919930374237
232,5366.251830161253,1025,5449.725274725102,53.66251830161253,54.497252747251025,2230,2637,1884,6751,33.03214338616501,39.06087986964894,27.906976744186046,2101,3212,1438,6751,31.12131536068731,47.578136572359654,21.30054806695304
233,6881.039531479054,1027,6150.6868131865085,68.81039531479054,61.50686813186508,3924,3389,2213,9526,41.192525719084614,35.57631744698719,23.231156833928196,3663,2771,3092,9526,38.4526558891455,29.088809573798024,32.45853453705648
234,3009.930555555426,1029,3829.4186046512964,30.09930555555426,38.29418604651296,2264,2412,1941,6617,34.21490101254345,36.4515641529394,29.333534834517156,2548,2378,1691,6617,38.50687622789784,35.93773613419979,25.55538763790237
235,5966.25,1033,7007.894736841792,59.6625,70.07894736841791,2648,2412,1534,6594,40.15771913861086,36.578707916287534,23.263572945101608,1860,3217,1517,6594,28.207461328480438,48.786775856839554,23.00576281468001
236,2509.663250366041,1043,3026.098901098899,25.096632503660413,30.260989010988993,805,914,475,2194,36.69097538742024,41.65907019143118,21.649954421148585,1066,697,431,2194,48.587055606198724,31.768459434822244,19.64448495897903
237,9759.66796875,1046,8223.07692307661,97.5966796875,82.23076923076609,2888,2960,2437,8285,34.85817742908871,35.727217863608935,29.414604707302356,3205,3259,1821,8285,38.684369342184674,39.33614966807483,21.979480989740495
238,7983.8213762814385,1047,7339.972527472273,79.83821376281439,73.39972527472273,2804,3285,2116,8205,34.17428397318708,40.036563071297984,25.789152955514933,2328,4137,1740,8205,28.372943327239486,50.42047531992687,21.206581352833638
239,4697.222222222096,1049,5210.348837209335,46.972222222220964,52.10348837209335,1611,1482,1767,4860,33.14814814814815,30.493827160493826,36.358024691358025,1739,2094,1027,4860,35.781893004115226,43.08641975308642,21.131687242798353
240,6661.786237189294,1051,7998.351648351312,66.61786237189294,79.98351648351313,3064,2949,2666,8679,35.303606406268,33.978568959557556,30.717824634174445,3131,3499,2049,8679,36.07558474478626,40.31570457425971,23.608710680954026
241,3193.84765625,1053,2744.531250000001,31.9384765625,27.44531250000001,71,75,85,231,30.735930735930733,32.467532467532465,36.79653679653679,90,108,33,231,38.961038961038966,46.75324675324675,14.285714285714285
242,12205.078125,1071,10512.22527472459,122.05078125,105.1222527472459,3149,3363,2265,8777,35.87786259541985,38.31605332118036,25.806084083399796,2617,4263,1897,8777,29.81656602483764,48.57012646690213,21.613307508260228
243,5092.972181552201,1073,5876.42276422783,50.92972181552201,58.7642276422783,2510,2001,1772,6283,39.94906891612287,31.84784338691708,28.20308769696005,1476,3495,1312,6283,23.49196243832564,55.62629317205157,20.881744389622792
244,18367.777777778374,1077,38564.56211812698,183.67777777778375,385.6456211812698,4595,4384,33740,42719,10.756337929258644,10.262412509656125,78.98124956108524,3699,4684,34336,42719,8.658910555022356,10.964676139422739,80.3764133055549
245,3528.59375,1082,2487.59765625,35.2859375,24.8759765625,1401,1316,610,3327,42.11000901713255,39.5551547941088,18.33483618875864,1381,1363,583,3327,41.508866847009315,40.9678388938984,17.523294259092275
246,6897.877013177503,1089,6103.434065933806,68.97877013177502,61.034340659338056,2481,2708,2437,7626,32.53343823760818,35.51009703645423,31.956464725937582,2087,3990,1549,7626,27.366902701285078,52.32100708103855,20.31209021767637
247,6151.4641288435405,1096,5991.07142857128,61.514641288435406,59.9107142857128,2286,2272,1760,6318,36.182336182336186,35.96074707185819,27.85691674580563,2921,2077,1320,6318,46.23298512187401,32.87432731877176,20.892687559354226
248,4930.339138405043,1101,5496.529284164606,49.30339138405043,54.96529284164606,2126,1770,2640,6536,32.52753977968176,27.080783353733167,40.39167686658507,1927,3165,1444,6536,29.482864137086906,48.42411260709915,22.093023255813954
249,2728.916544655931,1102,2281.868131868133,27.28916544655931,22.818681318681328,182,177,183,542,33.579335793357934,32.656826568265686,33.76383763837638,210,251,81,542,38.74538745387454,46.309963099631,14.944649446494465
250,6539.458272328554,1103,6443.818681318323,65.39458272328554,64.43818681318322,3006,3068,2821,8895,33.79426644182125,34.49128724002249,31.71444631815627,2905,3810,2180,8895,32.65879707700955,42.83305227655986,24.50815064643058
251,3756.9117647060057,1104,4996.153846153707,37.569117647060054,49.96153846153707,3114,3289,2176,8579,36.29793682247348,38.337801608579085,25.364261568947427,2545,3897,2137,8579,29.665462175078684,45.42487469402028,24.909663130901038
252,6850.878477306402,1105,7254.557291666451,68.50878477306402,72.54557291666451,4852,5183,4114,14149,34.29217612552124,36.63156406813202,29.076259806346737,3065,6405,4679,14149,21.66230829033854,45.26821683511202,33.069474874549435
253,10073.060029282788,1108,8292.994505493663,100.73060029282787,82.92994505493664,6998,8652,3775,19425,36.02574002574003,44.54054054054054,19.433719433719435,4887,6778,7760,19425,25.15830115830116,34.89317889317889,39.94851994851995
254,4535.285505124582,1110,4959.065934065755,45.352855051245825,49.590659340657545,2751,2052,2147,6950,39.58273381294964,29.52517985611511,30.892086330935253,1792,3465,1693,6950,25.784172661870503,49.856115107913666,24.359712230215827
255,4850.625,1111,6084.302325581424,48.50625,60.843023255814245,2902,1668,1818,6388,45.42892924232937,26.111458985597995,28.459611772072634,2575,2312,1501,6388,40.309956167814654,36.19286161552912,23.49718221665623
256,7676.500732064752,1112,9000.961538460968,76.76500732064751,90.00961538460967,2846,3417,2276,8539,33.32942967560604,40.016395362454624,26.654174961939336,2707,3985,1847,8539,31.701604403325916,46.66822812975758,21.6301674669165
257,10773.938506588667,1114,10104.258241757678,107.73938506588667,101.04258241757678,3350,3203,11794,18347,18.25911593175996,17.4578950237096,64.28298904453044,3333,3913,11101,18347,18.16645773150924,21.327737504769175,60.50580476372159
258,9229.088277857498,1115,8918.435013261536,92.29088277857498,89.18435013261536,4669,5006,4519,14194,32.89418063970692,35.26842327744117,31.83739608285191,4846,5738,3610,14194,34.141186416795826,40.42553191489361,25.433281668310553
259,4893.3382137629405,1119,5486.538461538297,48.93338213762941,54.86538461538297,2692,2313,2065,7070,38.076379066478076,32.71570014144272,29.207920792079207,2085,3508,1477,7070,29.490806223479492,49.61810466760962,20.89108910891089
260,946.4128843338194,1120,787.9120879120874,9.464128843338194,7.879120879120873,295,336,103,734,40.19073569482289,45.776566757493185,14.032697547683922,280,209,245,734,38.14713896457766,28.47411444141689,33.37874659400545
261,4874.963396779094,1121,4521.84065934056,48.74963396779094,45.2184065934056,2582,2388,1977,6947,37.1671224989204,34.374550165539084,28.458327335540524,2492,2758,1697,6947,35.87159925147546,39.700590182812725,24.42781056571182
262,5465.959004392605,1122,5594.642857142667,54.659590043926045,55.946428571426665,2837,2433,2455,7725,36.724919093851135,31.49514563106796,31.779935275080906,2693,3234,1798,7725,34.860841423948216,41.86407766990291,23.27508090614887
263,795.234375,1124,720.7894736842114,7.95234375,7.207894736842114,138,189,134,461,29.934924078091107,40.99783080260303,29.067245119305856,232,156,73,461,50.32537960954448,33.839479392624725,15.835140997830802
264,5451.286449399504,1125,5974.137931034704,54.51286449399504,59.741379310347035,1811,1842,1525,5178,34.97489378138277,35.573580533024334,29.451525685592895,1361,2532,1285,5178,26.284279644650443,48.8991888760139,24.81653147933565
265,5294.53125,1127,6220.394736841927,52.9453125,62.203947368419264,1653,1712,2009,5374,30.75921101600298,31.857089691105323,37.383699292891706,1939,2397,1038,5374,36.08113137327875,44.60364719017492,19.315221436546334
266,4324.524158125991,1128,6572.390109889578,43.245241581259904,65.72390109889578,3601,3507,2442,9550,37.70680628272251,36.72251308900524,25.570680628272253,2355,4878,2317,9550,24.659685863874344,51.07853403141361,24.26178010471204
267,10827.96486090759,1130,9779.945054944288,108.2796486090759,97.79945054944288,3499,3053,2554,9106,38.4252141445201,33.5273446079508,28.047441247529104,3158,3758,2190,9106,34.68043048539425,41.269492642213926,24.05007687239183
268,5240.3125,1131,5901.578947368173,52.403125,59.015789473681735,2051,2780,1647,6478,31.661006483482556,42.91447977770917,25.424513738808272,1960,2932,1586,6478,30.256251929607902,45.260882988576725,24.482865081815376
269,3780.161054172786,1132,4592.582417582321,37.80161054172786,45.92582417582321,1939,2035,1824,5798,33.44256640220766,35.09830976198689,31.459123835805453,1897,2548,1353,5798,32.71817868230424,43.946188340807176,23.335632976888583
270,23655.783308933143,1141,16690.659340657247,236.55783308933144,166.90659340657245,12403,14519,3413,30335,40.88676446349101,47.862205373331136,11.251030163177846,8104,6969,15262,30335,26.7150156584803,22.97346299653865,50.311521344981045
271,3929.51388888879,1145,4642.4418604651655,39.2951388888879,46.424418604651656,2027,1628,1139,4794,42.282019190654985,33.95911556111806,23.75886524822695,1311,2402,1081,4794,27.34668335419274,50.104297037964116,22.54901960784314
272,5907.320644216752,1146,3845.1923076922935,59.07320644216752,38.45192307692294,868,906,563,2337,37.14163457424048,38.767650834403085,24.09071459135644,1149,774,414,2337,49.16559691912708,33.1193838254172,17.715019255455715
273,2664.3452380954345,1147,2848.01980198002,26.643452380954344,28.4801980198002,4037,3721,2920,10678,37.80670537553849,34.84734969095336,27.34594493350815,3180,4374,3124,10678,29.78085783854654,40.96272710245364,29.256415058999814
274,6341.581259150968,1150,5274.86263736256,63.415812591509685,52.748626373625605,1223,1659,609,3491,35.032941850472646,47.522199942709825,17.444858206817532,1052,1704,735,3491,30.13463191062733,48.811228874248066,21.054139215124607
275,2225.6249999999372,1151,2791.162790697726,22.256249999999373,27.91162790697726,1121,1383,1540,4044,27.720079129574675,34.19881305637983,38.0811078140455,1474,1872,698,4044,36.44906033630069,46.29080118694362,17.26013847675569
276,4709.809663250527,1153,5583.379120878939,47.09809663250527,55.83379120878939,2640,2717,1934,7291,36.20902482512687,37.2651213825264,26.525853792346727,1898,3519,1874,7291,26.032094362913185,48.26498422712934,25.70292140995748
277,3295.7540263543688,1154,4380.6318681318,32.957540263543684,43.806318681318,2809,1930,1711,6450,43.55038759689923,29.92248062015504,26.527131782945734,2494,2403,1553,6450,38.666666666666664,37.25581395348837,24.07751937984496
278,2838.7829912022476,1155,4113.186813186791,28.387829912022475,41.13186813186791,2285,2661,1372,6318,36.16650838873061,42.117758784425455,21.71573282684394,1765,3163,1390,6318,27.93605571383349,50.06331117442229,22.00063311174422
279,5751.244509517184,1156,5759.615384615072,57.51244509517184,57.59615384615072,4012,5896,3280,13188,30.42159538974826,44.70730967546254,24.871094934789202,3355,5114,4719,13188,25.43979375189566,38.777676675765846,35.78252957233849
280,6884.480234260985,1158,5873.076923076606,68.84480234260985,58.730769230766064,3980,4951,2712,11643,34.18362964871597,42.5234046208022,23.292965730481836,3276,4466,3901,11643,28.137078072661687,38.35781156059434,33.50511036674397
281,7706.954612006155,1160,8063.049450549064,77.06954612006155,80.63049450549065,2934,3457,3687,10078,29.11291923000595,34.30244096050804,36.584639809486006,3081,4836,2161,10078,30.571541972613613,47.98571145068466,21.442746576701726
282,5275.078125,1161,6835.657894736521,52.75078125,68.35657894736521,2614,2577,1497,6688,39.084928229665074,38.531698564593306,22.383373205741627,1837,3191,1660,6688,27.467105263157894,47.71232057416268,24.820574162679428
283,4147.877013177153,1162,5191.758241758038,41.478770131771526,51.91758241758038,3303,2975,4070,10348,31.91921144182451,28.749516814843446,39.331271743332046,3280,4553,2515,10348,31.696946269810596,43.998840355624274,24.304213374565133
284,7178.8888888888905,1163,32187.500000000207,71.7888888888889,321.87500000000205,151,162,1834,2147,7.03306939916162,7.545412203074056,85.42151839776432,484,1423,240,2147,22.543083372147183,66.27852817885422,11.178388448998602
285,14651.09375,1164,11438.947368419935,146.5109375,114.38947368419934,4538,5101,2602,12241,37.07213462952373,41.67143207254309,21.256433297933174,3308,4724,4209,12241,27.02393595294502,38.59161833183563,34.38444571521935
286,7753.953147877268,1165,7609.3406593403915,77.53953147877267,76.09340659340391,1948,2561,3284,7793,24.996791992814064,32.862825612729374,42.140382394456566,1987,4287,1519,7793,25.497241113820095,55.01090722443218,19.491851661747724
287,2751.6837481698485,1166,3317.0329670329,27.516837481698484,33.170329670329004,2402,2429,1366,6197,38.760690656769405,39.196385347748915,22.042923995481683,1925,2161,2111,6197,31.06341778279813,34.87171211876714,34.064870098434724
288,6774.743777452949,1167,7025.412087911701,67.74743777452949,70.25412087911701,4081,3875,1868,9824,41.54112377850163,39.44421824104234,19.014657980456025,3320,3893,2611,9824,33.79478827361563,39.62744299674267,26.577768729641694
289,6332.869692533174,1168,7312.22527472507,63.32869692533174,73.1222527472507,1972,1929,2656,6557,30.07472929693457,29.418941589141372,40.50632911392405,2018,3089,1450,6557,30.77626963550404,47.1099588226323,22.11377154186366
290,5798.90625,1169,6284.605263157474,57.9890625,62.846052631574736,3235,3464,2197,8896,36.364658273381295,38.938848920863315,24.696492805755398,2818,3800,2278,8896,31.677158273381295,42.7158273381295,25.60701438848921
291,11819.930555556104,1170,13555.93023255667,118.19930555556104,135.5593023255667,9071,9500,32256,50827,17.846813701379187,18.69085328663899,63.46233301198182,7199,11702,31926,50827,14.163731874790958,23.02319633265784,62.8130717925512
292,10639.385065886272,1171,11818.68131867915,106.39385065886272,118.1868131867915,7714,7589,5407,20710,37.247706422018354,36.644133268952196,26.108160309029454,6750,8604,5356,20710,32.592950265572185,41.545147271849345,25.861902462578463
293,1772.2873900293241,1172,1654.6703296703317,17.72287390029324,16.546703296703317,180,132,97,409,44.00977995110024,32.27383863080684,23.71638141809291,185,146,78,409,45.2322738386308,35.69682151589242,19.070904645476773
294,2074.816983894591,1173,2730.219780219779,20.74816983894591,27.30219780219779,576,681,328,1585,36.34069400630915,42.965299684542586,20.694006309148268,852,479,254,1585,53.753943217665615,30.22082018927445,16.025236593059937
295,4397.877013177194,1174,5340.521978021902,43.978770131771945,53.40521978021902,2497,1967,7801,12265,20.35874439461883,16.03750509580106,63.6037505095801,2382,2502,7381,12265,19.421116999592336,20.39951080309825,60.17937219730942
296,8972.847222221868,1175,8415.11627906953,89.72847222221868,84.15116279069531,5966,6162,3206,15334,38.907004043302464,40.185209338724405,20.90778661797313,4381,6229,4724,15334,28.570496934915873,40.622146863179864,30.807356201904263
297,9500.732064421709,1176,7788.598901098842,95.00732064421709,77.88598901098842,1102,1196,660,2958,37.254901960784316,40.43272481406356,22.31237322515213,1166,1102,690,2958,39.4185260311021,37.254901960784316,23.32657200811359
298,5813.4699853591155,1177,6921.291208790788,58.13469985359116,69.21291208790788,3639,3404,2866,9909,36.72419013018468,34.35260873952972,28.923201130285598,2725,4847,2337,9909,27.500252295892626,48.91512766172167,23.58462004238571
299,12361.171875,1180,6717.368421052042,123.61171875,67.17368421052042,5549,8352,2797,16698,33.23152473350102,50.01796622349982,16.750509042999163,3933,5086,7679,16698,23.553719008264462,30.458737573362075,45.987543418373455
300,12287.042459736349,1181,9665.521978021328,122.8704245973635,96.65521978021329,3358,3088,2589,9035,37.166574432761486,34.178195904814615,28.65522966242391,2302,4957,1776,9035,25.4786939679026,54.86441615938019,19.656889872717212
301,2136.3636363636892,1182,2114.349376114041,21.363636363636893,21.143493761140412,1930,2143,2059,6132,31.47423352902805,34.94781474233529,33.57795172863666,2131,2194,1807,6132,34.75212002609263,35.779517286366605,29.468362687540772
302,11612.578125,1185,7143.379633889136,116.12578125,71.43379633889136,7573,7549,1969,17091,44.309870692177164,44.16944590720262,11.520683400620209,5568,5726,5797,17091,32.57855011409514,33.50301328184425,33.918436604060616
303,8073.611111111116,1186,46596.68367346934,80.73611111111116,465.9668367346934,170,168,3031,3369,5.046007717423568,4.986642920747997,89.96734936182843,2279,831,259,3369,67.6461858118136,24.66607301869991,7.687741169486495
304,3832.552083333223,1188,4290.970873963135,38.32552083333223,42.90970873963135,3818,3728,3469,11015,34.66182478438493,33.84475714934181,31.493418066273264,2046,5138,3831,11015,18.574670903313663,46.64548343168406,34.77984566500227
305,3352.8549382717733,1189,2790.1980198018696,33.528549382717735,27.901980198018695,3553,3875,3131,10559,33.64901979354106,36.69855099914764,29.652429207311297,2952,4094,3513,10559,27.957192915995833,38.77261104271238,33.27019604129179
306,2893.3284457477944,1190,3956.5934065934034,28.933284457477942,39.56593406593404,515,497,493,1505,34.21926910299003,33.02325581395349,32.757475083056484,411,672,422,1505,27.308970099667775,44.651162790697676,28.039867109634553
307,5092.1875,1191,5897.939560439352,50.921875,58.979395604393524,2577,2672,2244,7493,34.39209929267316,35.65994928600026,29.947951421326575,2621,3151,1721,7493,34.97931402642466,42.05258241024957,22.96810356332577
308,3631.771595900455,1193,4349.999999999828,36.31771595900455,43.49999999999828,3074,2968,2335,8377,36.695714456249256,35.430344992240656,27.873940551510085,2326,3863,2188,8377,27.766503521547094,46.11436074967172,26.119135728781185
309,3206.0029282577248,1194,4186.538461538405,32.06002928257725,41.865384615384045,2621,1972,1531,6124,42.79882429784455,32.20117570215545,25.0,2370,2419,1335,6124,38.70019595035924,39.50032658393207,21.799477465708687
310,4914.568081991266,1196,4157.142857142835,49.145680819912656,41.57142857142835,1187,1085,444,2716,43.703976435935196,39.948453608247426,16.347569955817377,836,1207,673,2716,30.78055964653903,44.44035346097201,24.779086892488955
311,8362.578125,1197,6925.657894736221,83.62578125,69.25657894736221,5003,4799,3451,13253,37.74994340903946,36.21066928242662,26.039387308533918,2969,5564,4720,13253,22.40247491134083,41.98294725722478,35.61457783143439
312,5642.532942899238,1198,6785.714285714026,56.425329428992384,67.85714285714026,2664,2007,1784,6455,41.270333075135554,31.09217660728118,27.637490317583268,1722,3389,1344,6455,26.67699457784663,52.50193648334624,20.821068938807127
313,20674.38095238209,1199,9450.129822243032,206.7438095238209,94.50129822243032,7853,9319,6344,23516,33.394284742303114,39.62833815274707,26.977377104949824,6194,7896,9426,23516,26.339513522707943,33.57713896921245,40.083347508079605
314,4952.049780380818,1200,5223.351648351511,49.52049780380818,52.23351648351511,1726,1643,1795,5164,33.42370255615802,31.816421378776145,34.75987606506584,1381,2652,1131,5164,26.742835011618897,51.35553834237025,21.901626646010843
315,8721.875,1202,5318.837209302439,87.21875,53.18837209302439,5821,7992,3344,17157,33.92784286297138,46.58157020458122,19.4905869324474,4193,5691,7273,17157,24.439004487964098,33.17013463892289,42.39086087311302
316,1312.2395833333308,1203,2282.2115384614717,13.122395833333307,22.82211538461472,1253,1390,2524,5167,24.25004838397523,26.901490226437,48.84846138958777,1564,2661,942,5167,30.269014902264367,51.49990323204955,18.231081865686086
317,4072.395833333283,1204,5576.319612140395,40.72395833333283,55.76319612140395,1615,1860,3450,6925,23.32129963898917,26.859205776173283,49.81949458483754,2210,3743,972,6925,31.91335740072202,54.05054151624549,14.03610108303249
318,4500.21961932651,1205,4154.9450549448175,45.0021961932651,41.549450549448174,4582,3865,3333,11780,38.89643463497453,32.80984719864177,28.2937181663837,1602,5535,4643,11780,13.599320882852291,46.98641765704584,39.41426146010187
319,2046.1458333332669,1206,2464.5370370371857,20.46145833333267,24.645370370371857,3293,3464,4244,11001,29.933642396145803,31.488046541223525,38.57831106263067,1992,5304,3705,11001,18.107444777747478,48.21379874556859,33.67875647668394
320,5453.513909224233,1208,5742.85714285702,54.53513909224233,57.4285714285702,2625,2167,2414,7206,36.42797668609492,30.072162087149596,33.499861226755485,2205,3460,1541,7206,30.599500416319735,48.015542603386066,21.3849569802942
321,6058.418740849735,1209,6490.659340658951,60.58418740849734,64.90659340658951,2859,3572,2560,8991,31.798465131798466,39.72861750639529,28.47291736180625,2121,4655,2215,8991,23.590256923590257,51.773996218440665,24.635746857969078
322,2887.9687499999804,1210,3313.4615384613226,28.879687499999804,33.13461538461323,3882,3594,3265,10741,36.14188623033237,33.46057164137417,30.397542128293452,2851,4299,3591,10741,26.54315240666605,40.02420631226143,33.43264128107253
323,4846.266471449639,1211,6238.210227272472,48.462664714496384,62.38210227272472,2174,2670,3084,7928,27.421796165489404,33.67810292633703,38.90010090817356,2419,3778,1731,7928,30.512108980827445,47.65388496468214,21.834006054490413
324,9733.016105417344,1213,10374.725274724433,97.33016105417344,103.74725274724433,2786,2632,3681,9099,30.618749313111334,28.926255632487084,40.454995054401586,2938,4484,1677,9099,32.28926255632487,49.280140674799426,18.430596768875702
325,16436.422764226212,1217,8318.81606765335,164.3642276422621,83.1881606765335,7458,8035,2452,17945,41.56032320980775,44.775703538590136,13.663973251602119,5851,5451,6643,17945,32.60518250208972,30.37614934522151,37.018668152688775
326,4112.5625,1218,4905.348837209443,41.125625,49.053488372094435,3300,3472,1968,8740,37.75743707093822,39.725400457665906,22.51716247139588,2877,3516,2347,8740,32.91762013729977,40.22883295194508,26.85354691075515
327,2664.7877013177235,1219,3897.039071937089,26.647877013177236,38.97039071937089,2594,2738,2222,7554,34.339422822345774,36.24569764363251,29.414879534021708,2216,3275,2063,7554,29.335451416468096,43.354514164680964,27.310034418850943
328,2546.458333333133,1220,2876.2222222222836,25.46458333333133,28.762222222222835,2769,3577,3461,9807,28.234934230651575,36.4739471805853,35.291118588763126,2186,3964,3657,9807,22.290200876924647,40.42010808606098,37.28969103701438
329,4385.724743777484,1222,4959.340659340506,43.85724743777484,49.593406593405064,2341,2288,2164,6793,34.46194612100692,33.68173119387605,31.856322685117032,1550,3429,1814,6793,22.81760635948771,50.4784336817312,26.7039599587811
330,4801.756954612095,1224,6302.060439560361,48.017569546120946,63.02060439560361,1668,2202,1317,5187,32.15731636784268,42.45228455754771,25.390399074609597,2170,2162,855,5187,41.83535762483131,41.68112589165221,16.483516483516482
331,inf,1225,inf,inf,inf,7,5,0,12,58.333333333333336,41.66666666666667,0.0,5,3,0,8,62.5,37.5,0.0
332,8903.367496340206,1228,4400.274725274351,89.03367496340206,44.00274725274351,5015,8626,3326,16967,29.557376082984614,50.83986562150056,19.60275829551482,2858,5225,8884,16967,16.84446278069193,30.79507278835386,52.3604644309542
333,7577.5,1230,64409.61538461556,75.775,644.0961538461556,138,151,2980,3269,4.221474457020496,4.619149587029673,91.15937595594983,1385,1654,230,3269,42.36769654328541,50.596512695013764,7.035790761700826
334,4872.327964860909,1231,2605.6179775280925,48.723279648609086,26.056179775280924,118,132,343,593,19.898819561551434,22.259696458684655,57.84148397976391,58,292,243,593,9.780775716694773,49.24114671163575,40.97807757166947
335,1633.8709677419347,1233,1901.0989010989033,16.338709677419345,19.010989010989032,203,186,72,461,44.03470715835141,40.3470715835141,15.61822125813449,183,202,76,461,39.69631236442516,43.817787418655094,16.48590021691974
336,10484.732272068683,1234,7362.096774194012,104.84732272068682,73.62096774194012,5208,4763,2932,12903,40.362706347361076,36.91389599317988,22.723397659459042,3874,4434,4595,12903,30.024025420444854,34.364101371774005,35.61187320778114
337,7913.349514563113,1239,70120.88541008573,79.13349514563113,701.2088541008573,170,196,2494,2860,5.944055944055944,6.853146853146853,87.2027972027972,663,1926,271,2860,23.18181818181818,67.34265734265735,9.475524475524475
338,3337.5520833333367,1240,2416.153846153703,33.37552083333337,24.16153846153703,4298,3693,2331,10322,41.63921720596784,35.77795000968805,22.58283278434412,2195,3596,4531,10322,21.265258670800232,34.83820964929277,43.896531679907
339,4610.875,1244,5321.1627906978965,46.10875,53.21162790697897,4958,5827,3271,14056,35.27319294251565,41.455606146841205,23.27120091064314,3740,5739,4577,14056,26.607854297097326,40.829538986909505,32.56260671599317
340,1992.16691068818,1248,3258.379120879076,19.9216691068818,32.58379120879076,1784,1918,2288,5990,29.78297161936561,32.02003338898163,38.19699499165276,3386,1527,1077,5990,56.52754590984975,25.49248747913189,17.979966611018362
341,3586.983471074329,1250,2170.2651515153884,35.86983471074329,21.702651515153885,8502,8137,2649,19288,44.079220240564084,42.18685192866031,13.733927830775611,3091,5669,10528,19288,16.02550808793032,29.39133139776027,54.58316051430941
342,5007.713498622676,1252,1994.8155533400013,50.07713498622675,19.948155533400012,3613,3709,1558,8880,40.68693693693694,41.76801801801802,17.545045045045047,1919,2869,4092,8880,21.61036036036036,32.30855855855856,46.08108108108108
343,4536.090775988385,1255,5033.379120878947,45.36090775988385,50.33379120878947,2839,2717,3033,8589,33.053906159040636,31.63348468971941,35.31260915123996,2243,3618,2728,8589,26.114797997438583,42.12364652462452,31.7615554779369
344,4677.34375,1256,4863.815789473491,46.7734375,48.63815789473492,2249,1840,1696,5785,38.87640449438202,31.80639585133967,29.31719965427831,2172,2477,1136,5785,37.54537597234226,42.81763180639585,19.636992221261885
345,7610.277777777782,1260,36915.41668419321,76.10277777777782,369.15416684193207,144,161,3141,3446,4.178757980266976,4.672083575159605,91.14915844457342,1050,2163,233,3446,30.470110272780033,62.76842716192688,6.761462565293093
346,6877.222222222221,1263,32050.32467532477,68.77222222222221,320.5032467532477,131,166,2400,2697,4.85724879495736,6.154987022617724,88.98776418242491,1025,1442,230,2697,38.00519095291064,53.466814979606966,8.527994067482387
347,98.02083333333336,1265,214.90384615384605,0.9802083333333336,2.1490384615384603,110,119,176,405,27.160493827160494,29.38271604938272,43.45679012345679,146,188,71,405,36.04938271604938,46.41975308641975,17.530864197530864
348,8236.822840410314,1268,7800.686813186495,82.36822840410314,78.00686813186495,2135,2399,3098,7632,27.97431865828092,31.43343815513627,40.59224318658281,2868,3146,1618,7632,37.57861635220126,41.221174004192875,21.20020964360587
349,6544.166666666664,1269,32039.705882352915,65.44166666666665,320.39705882352916,150,165,2389,2704,5.547337278106509,6.10207100591716,88.35059171597634,702,1746,256,2704,25.961538461538463,64.57100591715977,9.467455621301776
350,3306.198347107454,1270,3105.839416058429,33.06198347107454,31.05839416058429,5294,5370,2353,13017,40.669893216562954,41.25374510255819,18.07636168087885,3819,4396,4802,13017,29.338557271260658,33.77122224782976,36.89022048090958
351,4324.371069182073,1272,1921.3855421685403,43.24371069182073,19.213855421685402,4851,4940,7152,16943,28.63129315941687,29.156583839933898,42.212123000649235,3351,5244,8348,16943,19.77807944283775,30.9508351531606,49.27108540400165
352,4561.06052490619,1273,2649.2700729927183,45.6106052490619,26.492700729927183,4231,4595,1922,10748,39.36546334201712,42.75213993301079,17.88239672497209,2445,4144,4159,10748,22.74841831038333,38.55601042054336,38.69557126907331
353,5151.484375,1275,4004.875,51.51484375,40.04875,3062,3333,3199,9594,31.915780696268502,34.740462789243274,33.34375651448822,1830,4139,3625,9594,19.074421513445905,43.14154680008338,37.78403168647071
354,9724.408783783505,1276,7929.4947121037085,97.24408783783505,79.29494712103708,3985,3503,2813,10301,38.68556450830016,34.006407144937384,27.308028346762452,3141,3914,3246,10301,30.49218522473546,37.99631103776333,31.51150373750121
355,1932.1874999999477,1278,3171.730769230525,19.321874999999476,31.717307692305248,3491,3008,3718,10217,34.1685426250367,29.4411275325438,36.3903298424195,4556,3463,2198,10217,44.592346089850246,33.894489576196534,21.513164333953217
356,25448.398902103163,1279,10594.270906970936,254.48398902103162,105.94270906970937,4702,4700,3037,12439,37.80046627542407,37.784387812525125,24.41514591205081,3905,4523,4011,12439,31.393198810193745,36.361443845968324,32.245357343837924
357,4333.333333333348,1280,2187.5000000001655,43.33333333333348,21.875000000001656,6328,6868,2942,16138,39.21179824017846,42.55793778659066,18.230263973230883,3411,5097,7630,16138,21.13644813483703,31.583839385301772,47.279712479861196
358,4909.882869692702,1281,5944.780219779947,49.09882869692702,59.447802197799476,3146,3210,2399,8755,35.93375214163335,36.664762992575675,27.401484865790977,2708,3942,2105,8755,30.930896630496857,45.02569960022844,24.0434037692747
359,6740.7569141189315,1282,4623.907103825495,67.40756914118931,46.23907103825495,4776,3816,1668,10260,46.54970760233918,37.19298245614035,16.257309941520468,2522,4101,3637,10260,24.580896686159846,39.97076023391813,35.448343079922026
360,2393.850658858043,1284,3774.725274725175,23.93850658858043,37.74725274725175,2861,2971,4218,10050,28.46766169154229,29.562189054726367,41.97014925373134,2013,4425,3612,10050,20.029850746268657,44.02985074626866,35.940298507462686
361,7077.777777777783,1285,36089.811655236655,70.77777777777783,360.89811655236656,135,157,2418,2710,4.981549815498155,5.793357933579336,89.22509225092251,1263,1207,240,2710,46.60516605166052,44.53874538745388,8.856088560885608
362,8612.9375,1286,7849.651162790616,86.129375,78.49651162790616,5662,5449,3745,14856,38.11254711900916,36.678782983306405,25.208669897684437,4558,5386,4912,14856,30.681206246634357,36.25471190091545,33.06408185245019
363,5871.522693997365,1287,6904.532967032699,58.715226939973654,69.04532967032699,2462,2633,2071,7166,34.35668434272955,36.74295283282166,28.900362824448788,2204,3641,1321,7166,30.756349427853753,50.80937761652247,18.43427295562378
364,4832.1875,1288,4489.186046511822,48.321875,44.891860465118214,3813,3802,2057,9672,39.42307692307692,39.30934656741108,21.267576509511994,1686,4540,3446,9672,17.431761786600497,46.93961952026468,35.628618693134825
365,5984.264705882579,1289,8224.999999999969,59.84264705882579,82.24999999999969,4088,4333,3129,11550,35.39393939393939,37.515151515151516,27.090909090909093,3983,4904,2663,11550,34.484848484848484,42.458874458874455,23.056277056277054
366,6433.671875,1293,6882.500000000623,64.33671875,68.82500000000623,6415,6547,6448,19410,33.04997424008243,33.7300360638846,33.219989696032975,5866,7971,5573,19410,30.221535291087072,41.06646058732612,28.71200412158681
367,7435.000000000006,1294,30596.590909090984,74.35000000000007,305.96590909090986,161,150,1662,1973,8.160162189559047,7.602635580334516,84.23720223010643,399,1340,234,1973,20.22301064368981,67.91687785098834,11.860111505321845
368,6395.021961932997,1295,6056.318681318388,63.95021961932997,60.56318681318388,3759,4912,2703,11374,33.04905925795674,43.18621417267452,23.764726569368737,3031,4841,3502,11374,26.648496571127133,42.561983471074385,30.78951995779849
369,9925.256222548285,1297,9510.57692307562,99.25256222548285,95.1057692307562,8443,7253,4745,20441,41.30424147546597,35.48260848295094,23.21315004158309,7209,7931,5301,20441,35.267354826084826,38.79947165011497,25.933173523800207
370,2863.1249999998417,1301,4000.9302325582116,28.631249999998417,40.00930232558212,2374,2192,1981,6547,36.26088284710555,33.480983656636624,30.258133496257827,2557,2854,1136,6547,39.056056208950665,43.59248510768291,17.351458683366427
371,5071.25,1302,6057.894736841595,50.7125,60.578947368415946,3721,3655,2915,10291,36.15780779321737,35.51647070255563,28.325721504226998,3158,4809,2324,10291,30.687008065299775,46.73015256048975,22.582839374210476
372,3121.1908110641634,1303,2056.333333333262,31.211908110641634,20.563333333332622,5696,5240,3763,14699,38.75093543778488,35.648683583917276,25.600380978297842,3261,5058,6380,14699,22.18518266548745,34.41050411592626,43.404313218586296
373,3519.3791946311003,1308,2355.0100200400375,35.193791946311,23.550100200400376,4105,3534,2278,9917,41.39356660280327,35.63577694867399,22.97065644852274,2057,4079,3781,9917,20.7421599273974,41.131390541494405,38.1264495311082
374,3590.6295754025778,1309,5067.187499999978,35.90629575402578,50.67187499999978,2927,3197,3276,9400,31.138297872340427,34.01063829787234,34.85106382978723,2245,4337,2818,9400,23.882978723404253,46.13829787234043,29.97872340425532
375,7381.405563690068,1310,5391.483516483105,73.81405563690069,53.91483516483105,4933,5488,3102,13523,36.478592028396065,40.582710936922275,22.938697034681653,2764,4883,5876,13523,20.439251645344967,36.108851586186496,43.451896768468536
376,1936.822916666633,1313,2568.45703125,19.36822916666633,25.6845703125,3337,3177,2722,9236,36.130359462970986,34.3980077955825,29.471632741446513,2905,4192,2139,9236,31.453009961022087,45.387613685578174,23.15937635339974
377,6658.593749999878,1314,3207.3076923073527,66.58593749999878,32.07307692307353,7448,9101,3902,20451,36.41875702899613,44.501491369615174,19.079751601388686,6033,5095,9323,20451,29.499779961860057,24.9132071781331,45.58701286000685
378,6085.212298682622,1315,4424.862637362148,60.85212298682622,44.248626373621484,5638,6187,4147,15972,35.29927372902579,38.736538943150514,25.96418732782369,2563,6308,7101,15972,16.046831955922865,39.49411470072627,44.45905334335086
379,4173.177083333317,1316,3794.7572793776267,41.731770833333165,37.94757279377627,1980,2296,1987,6263,31.614242375858215,36.659747724732554,31.72600989940923,1045,3333,1885,6263,16.685294587258504,53.21730799936133,30.09739741338017
380,5132.1875,1317,5068.604651163233,51.321875,50.68604651163233,5804,6546,4354,16704,34.74616858237548,39.18821839080459,26.06561302681992,4933,5912,5859,16704,29.531848659003828,35.39272030651341,35.075431034482754
381,4722.638888888395,1320,3260.930232558421,47.226388888883946,32.60930232558421,7261,6570,3965,17796,40.80130366374466,36.91840863115306,22.28028770510227,3044,6265,8487,17796,17.10496740840638,35.2045403461452,47.69049224544842
382,2443.6904761906217,1321,3840.2970297027987,24.436904761906217,38.402970297027984,3372,3531,3004,9907,34.03653982032906,35.64146563036237,30.321994549308567,4269,2955,2683,9907,43.090743918441504,29.82739477137378,27.081861310184717
383,3312.864583333377,1322,3341.21756487029,33.12864583333377,33.4121756487029,5484,5103,6918,17505,31.32819194515853,29.15167095115681,39.52013710368466,4885,4303,8317,17505,27.90631248214796,24.581548129105972,47.51213938874607
384,15724.158125914992,1323,16993.26923076859,157.2415812591499,169.9326923076859,4258,3655,2451,10364,41.08452335005789,35.266306445387876,23.649170204554228,3800,3952,2612,10364,36.665380162099574,38.13199536858356,25.202624469316863
385,6033.748169839149,1324,3847.52747252736,60.33748169839149,38.4752747252736,3421,3252,2434,9107,37.56451081585593,35.70879543208521,26.726693752058857,1929,3749,3429,9107,21.1815087295487,41.16613593938728,37.65235533106402
386,5252.929687500004,1326,6728.353511305404,52.529296875000036,67.28353511305404,6346,6302,5348,17996,35.26339186485885,35.018893087352744,29.717715047788396,5096,7044,5856,17996,28.317403867526114,39.142031562569464,32.540564569904426
387,7025.256222547997,1329,6849.31318681284,70.25256222547996,68.4931318681284,4239,4400,2666,11305,37.49668288367979,38.92083149049093,23.582485625829282,3442,4166,3697,11305,30.446704997788586,36.850950906678456,32.70234409553295
388,5452.781844802576,1330,5437.369791666621,54.52781844802576,54.3736979166662,3265,2853,2158,8276,39.45142580956984,34.47317544707588,26.075398743354278,2781,3029,2466,8276,33.60318994683422,36.599806669888835,29.797003383276945
389,1991.0688140556583,1331,2176.923076923107,19.910688140556584,21.769230769231072,1045,1187,784,3016,34.648541114058354,39.356763925729446,25.9946949602122,969,1269,778,3016,32.12864721485411,42.07559681697613,25.795755968169757
390,2325.5208333333308,1332,3028.6407760335896,23.255208333333307,30.286407760335898,1001,899,547,2447,40.90723334695546,36.73886391499796,22.35390273804659,1058,746,643,2447,43.23661626481406,30.48630976706171,26.27707396812423
391,5864.772727272735,1334,85552.91666666693,58.64772727272735,855.5291666666693,232,175,4120,4527,5.124806715263971,3.865694720565496,91.00949856417053,1668,2383,476,4527,36.845593108018555,52.6397172520433,10.51468963993815
392,6550.000000000134,1336,4100.717592763839,65.50000000000134,41.00717592763839,8336,7564,3949,19849,41.99707793843518,38.10771323492367,19.89520882664114,4157,6747,8945,19849,20.943120560229733,33.99163685828002,45.06524258149025
393,4708.333333333259,1337,6441.785716797244,47.0833333333326,64.41785716797244,3185,3337,3097,9619,33.111550057178505,34.69175589978168,32.19669404303982,3413,4129,2077,9619,35.48185882108327,42.925460027029835,21.592681151886893
394,5110.76134699884,1338,8139.010989010564,51.1076134699884,81.39010989010563,4391,4242,3343,11976,36.664996659986635,35.42084168336673,27.914161656646623,3977,5075,2924,11976,33.20808283233133,42.37641950567802,24.41549766199065
395,6762.849872773537,1341,34821.90923317681,67.62849872773536,348.21909233176814,146,168,2928,3242,4.5033929673041335,5.1819864281307835,90.31462060456509,814,2194,234,3242,25.10795805058606,67.67427513880321,7.217766810610734
396,42810.53719007968,1342,369665.01736112044,428.1053719007968,3696.6501736112045,4203,4304,4921,13428,31.300268096514746,32.052427762883525,36.647304140601726,6256,5177,1995,13428,46.58921656240691,38.553768245457256,14.857015192135837
397,2675.907590759073,1344,2789.958158995819,26.75907590759073,27.89958158995819,128,150,452,730,17.534246575342465,20.54794520547945,61.917808219178085,304,272,154,730,41.64383561643836,37.26027397260274,21.095890410958905
398,5003.163331181522,1347,4251.360946745839,50.03163331181522,42.513609467458394,8811,8297,5330,22438,39.268205722435155,36.97744897049648,23.754345307068366,4987,6501,10950,22438,22.225688564043143,28.97317051430609,48.80114092165077
399,5513.736979166779,1349,4759.223300218715,55.13736979166779,47.59223300218715,5975,4521,2854,13350,44.756554307116104,33.86516853932584,21.378277153558052,2507,4899,5944,13350,18.779026217228463,36.69662921348314,44.52434456928839
400,7209.479015918525,1353,5212.500000000406,72.09479015918525,52.12500000000406,4762,4228,1512,10502,45.34374404875262,40.25899828604075,14.397257665206627,2538,5064,2900,10502,24.16682536659684,48.219386783469815,27.613787849933345
401,6105.783308931355,1354,6888.736263736107,61.057833089313554,68.88736263736106,2018,2123,2325,6466,31.209403031240335,32.83328178162697,35.95731518713269,2017,3101,1348,6466,31.19393751933189,47.95855242808537,20.84751005258274
402,8566.83884297458,1356,9413.138686130565,85.66838842974579,94.13138686130566,4935,4445,2504,11884,41.52642208010771,37.40323123527432,21.070346684617974,3349,4489,4046,11884,28.180747223157187,37.773476943789966,34.04577583305284
403,10691.765782251101,1357,6059.513889419323,106.917657822511,60.595138894193234,5014,7167,3791,15972,31.39243676433759,44.87227648384673,23.735286751815675,2782,5288,7902,15972,17.417981467568243,33.10793889306286,49.474079639368895
404,4942.916666666984,1358,3573.168316831553,49.42916666666984,35.73168316831553,5590,4623,1401,11614,48.13156535216119,39.80540726709144,12.063027380747373,4255,3809,3550,11614,36.63681763389013,32.79662476321681,30.566557602893056
405,2963.95833333323,1359,4153.037974683699,29.639583333332297,41.530379746836985,1865,2163,4302,8330,22.388955582232896,25.966386554621852,51.64465786314526,1838,4401,2091,8330,22.064825930372148,52.83313325330133,25.102040816326532
406,7993.333333333338,1361,36513.85135135161,79.93333333333338,365.1385135135161,148,163,3182,3493,4.23704551961065,4.666475808760378,91.09647867162897,623,2618,252,3493,17.835671342685373,74.9498997995992,7.214428857715431
407,6390.409956076505,1365,4902.335164834817,63.904099560765054,49.02335164834817,5697,5503,2861,14061,40.5163217409857,39.13661901713961,20.34705924187469,3555,4764,5742,14061,25.28269682099424,33.880947301045445,40.836355877960315
408,2713.9880952382487,1368,2617.9207920791087,27.139880952382487,26.179207920791086,3804,3562,2229,9595,39.645648775403856,37.1235018238666,23.230849400729547,1968,3949,3678,9595,20.51068264721209,41.156852527358,38.33246482542991
409,5063.4375,1371,5336.842105263093,50.634375,53.36842105263093,990,1174,617,2781,35.59870550161812,42.215030564545124,22.18626393383675,1179,1010,592,2781,42.394822006472495,36.317871269327576,21.28730672419993
410,10692.075163397018,1375,5579.156010230687,106.92075163397017,55.79156010230687,7852,8514,2039,18405,42.66232002173322,46.25916870415648,11.078511274110296,3886,5440,9079,18405,21.11382776419451,29.557185547405595,49.32898668839989
411,2319.326500732079,1376,2662.912087912099,23.19326500732079,26.629120879120993,801,681,419,1901,42.13571804313519,35.82325092056812,22.041031036296683,815,687,399,1901,42.87217254076802,36.13887427669648,20.988953182535507
412,10785.212298682312,1377,9837.225274724193,107.85212298682312,98.37225274724193,5281,4885,3373,13539,39.00583499519906,36.080951325799546,24.9132136790014,4060,5634,3845,13539,29.987443681217226,41.61311766009306,28.399438658689714
413,7337.0875995441465,1379,50603.30578512329,73.37087599544147,506.03305785123285,4255,2410,11671,18336,23.205715532286213,13.143542757417103,63.650741710296685,7917,8551,1868,18336,43.17735602094241,46.63503490401396,10.18760907504363
414,2263.703416149251,1380,2484.6590909093193,22.63703416149251,24.846590909093194,4558,4123,2865,11546,39.4768751082626,35.70933656677637,24.813788324961024,3278,4497,3771,11546,28.390784687337607,38.9485536116404,32.660661701022
415,5185.48177083339,1381,3770.679610345773,51.854817708333904,37.706796103457734,5492,3628,3191,12311,44.610510925188855,29.469580050361465,25.919909024449677,2911,4892,4508,12311,23.645520266428395,39.73682072942897,36.61765900414264
416,537.96875,1384,7858.905539441466,5.3796875,78.58905539441466,12,14,160,186,6.451612903225806,7.526881720430108,86.02150537634408,14,152,20,186,7.526881720430108,81.72043010752688,10.75268817204301
417,6825.190839694648,1385,26927.233429394786,68.25190839694648,269.27233429394784,136,174,1973,2283,5.957074025405169,7.6215505913272015,86.42137538326763,708,1334,241,2283,31.011826544021027,58.43188786684187,10.5562855891371
418,5209.635416666686,1386,3707.3148131593903,52.09635416666686,37.0731481315939,6380,6170,4721,17271,36.94053615887904,35.72462509408836,27.3348387470326,4258,5318,7695,17271,24.6540443518036,30.791500202651847,44.554455445544555
419,5597.584187408816,1389,5810.989010988622,55.97584187408816,58.109890109886216,4155,4265,2511,10931,38.0111609184887,39.01747324124051,22.97136584027079,2484,5060,3387,10931,22.724361906504438,46.29036684658311,30.98527124691245
420,3223.308823529413,1390,2903.0219780219763,32.23308823529413,29.030219780219763,166,165,288,619,26.81744749596123,26.65589660743134,46.52665589660743,70,296,253,619,11.308562197092083,47.81906300484653,40.87237479806139
421,5283.23572474401,1391,6357.280219779815,52.83235724744011,63.57280219779815,3298,3915,3294,10507,31.388598077472164,37.26087370324546,31.35052821928238,2930,4932,2645,10507,27.886171124012566,46.94013514799658,25.173693727990866
422,3336.8750000000614,1394,3023.4615384612885,33.36875000000062,30.234615384612884,4762,5599,3059,13420,35.484351713859915,41.721311475409834,22.794336810730254,3487,5579,4354,13420,25.983606557377048,41.57228017883756,32.4441132637854
423,4150.512445095222,1395,4559.478021977822,41.505124450952216,45.59478021977822,3456,3514,2286,9256,37.33794295592048,37.964563526361275,24.697493517718236,2874,3526,2856,9256,31.050129645635266,38.09420916162489,30.85566119273985
424,6225.988286969497,1398,6430.906593406238,62.25988286969496,64.30906593406239,3474,4552,2719,10745,32.33131689157748,42.36389018147976,25.304792926942767,2633,5043,3069,10745,24.504420660772453,46.93345742205677,28.562121917170778
425,5544.655929722008,1399,4202.335164835005,55.446559297220084,42.02335164835005,4761,4418,2777,11956,39.82101037136166,36.95215791234527,23.226831716293077,2522,4584,4850,11956,21.09401137504182,38.34058213449314,40.56540649046504
426,5356.75,1400,3680.3488372094703,53.5675,36.803488372094705,3952,3950,1975,9877,40.01214943808849,39.991900374607674,19.995950187303837,2661,3654,3562,9877,26.941378961223045,36.995038979447195,36.06358205932976
427,5199.26793557853,1404,5276.373626373442,51.992679355785306,52.763736263734415,2640,3661,3032,9333,28.286724525875922,39.22640094289081,32.486874531233255,2303,4420,2610,9333,24.67588128147434,47.35883424408014,27.965284474445518
428,6429.5625,1408,5421.976744186183,64.295625,54.21976744186183,6012,5888,3317,15217,39.508444502858644,38.693566405993295,21.797989091148057,3971,4842,6404,15217,26.095813892357235,31.819675363080762,42.084510744562
429,6364.21875,1409,5675.263157894643,63.6421875,56.75263157894643,1050,1082,555,2687,39.077037588388535,40.26795682917752,20.65500558243394,1069,1074,544,2687,39.784145887606996,39.970227018980275,20.245627093412725
430,8811.128284389546,1412,5921.606254442137,88.11128284389547,59.21606254442136,3067,3126,2295,8488,36.13336475023562,36.82846371347785,27.03817153628652,2348,3774,2366,8488,27.66258246936852,44.46277097078228,27.874646559849197
431,3336.603221083456,1413,4599.450549450417,33.36603221083456,45.994505494504175,2592,2505,2085,7182,36.09022556390977,34.87886382623225,29.03091060985798,1800,3618,1764,7182,25.062656641604008,50.37593984962406,24.561403508771928
432,7134.642857143575,1415,5071.782178217954,71.34642857143575,50.71782178217954,6652,6498,3963,17113,38.87103371705721,37.97113305674049,23.1578332262023,5110,6208,5795,17113,29.86034009232747,36.276514930170045,33.863144977502486
433,5771.943048576448,1416,4564.072632943854,57.71943048576448,45.640726329438536,4986,3961,5286,14233,35.03126536921239,27.829691561863275,37.13904306892433,2913,3840,7480,14233,20.46652146420291,26.979554556312795,52.553923979484296
434,4123.854166666747,1420,3928.653846153516,41.23854166666747,39.28653846153516,6626,5605,2931,15162,43.70135865980742,36.96741854636591,19.331222793826672,3293,5937,5932,15162,21.71877061073737,39.1571032845271,39.124126104735524
435,3417.625,1422,4412.171837708902,34.17625,44.12171837708902,2774,2733,1387,6894,40.23788801856687,39.6431679721497,20.118944009283435,1464,3645,1785,6894,21.23585726718886,52.87206266318538,25.892080069625763
436,3652.239583333377,1424,3270.6730769228157,36.522395833333775,32.70673076922816,4442,4292,2991,11725,37.88486140724947,36.60554371002132,25.509594882729207,4282,3843,3600,11725,36.52025586353945,32.776119402985074,30.703624733475483
437,7644.166666666662,1425,36669.107142857116,76.44166666666662,366.69107142857115,130,163,2932,3225,4.0310077519379846,5.054263565891473,90.91472868217055,813,2173,239,3225,25.209302325581394,67.37984496124031,7.4108527131782935
438,9352.533783783767,1427,184171.07142857133,93.52533783783767,1841.7107142857133,209,239,4536,4984,4.193418940609952,4.795345104333868,91.01123595505618,1392,3336,256,4984,27.929373996789725,66.93418940609952,5.136436597110754
439,3002.854938271763,1428,2583.8999999998323,30.028549382717628,25.83899999999832,2910,3241,2441,8592,33.86871508379888,37.72113594040968,28.410148975791433,1755,4699,2138,8592,20.425977653631286,54.690409683426445,24.883612662942273
440,2819.615384615385,1429,3138.991175192373,28.19615384615385,31.389911751923727,122,121,341,584,20.89041095890411,20.71917808219178,58.390410958904106,89,256,239,584,15.23972602739726,43.83561643835616,40.92465753424658
441,6427.52562225526,1431,7379.807692307089,64.2752562225526,73.7980769230709,4252,4910,4254,13416,31.693500298151463,36.59809183064997,31.708407871198567,4015,5673,3728,13416,29.92695289206917,42.28533094812165,27.787716159809182
442,3551.5972222222017,1436,4149.069767441868,35.51597222222202,41.490697674418676,890,838,654,2382,37.36356003358522,35.18052057094878,27.455919395465994,619,1253,510,2382,25.98656591099916,52.60285474391267,21.41057934508816
443,1497.1354166666508,1437,2933.5238095236364,14.971354166666508,29.335238095236363,1770,1553,3491,6814,25.97593190490167,22.791312004696213,51.23275609040211,2010,2840,1964,6814,29.498092163193423,41.678896389785734,28.82301144702084
444,0.0,1438,inf,0.0,inf,0,0,0,0,,,,9,2,0,11,81.81818181818183,18.181818181818183,0.0
445,4988.653001464311,1439,4255.357142856907,49.886530014643114,42.553571428569064,4301,3954,2777,11032,38.98658448150834,35.84118926758521,25.172226250906455,1763,4946,4323,11032,15.980783176214649,44.83321247280638,39.18600435097897
446,5921.926671459218,1441,4922.697325908952,59.21926671459218,49.22697325908952,1673,1626,4904,8203,20.394977447275387,19.822016335487017,59.7830062172376,1321,1196,5686,8203,16.103864439839082,14.580031695721077,69.31610386443984
447,2573.124999999901,1443,4024.42284325632,25.731249999999008,40.2442284325632,1591,1670,3751,7012,22.68967484312607,23.816314888762122,53.494010268111815,1886,3306,1820,7012,26.896748431260697,47.14774671990873,25.955504848830575
448,5066.019417475732,1444,23142.261066153776,50.660194174757315,231.42261066153776,121,147,1828,2096,5.772900763358779,7.013358778625954,87.21374045801527,1006,856,234,2096,47.99618320610687,40.839694656488554,11.164122137404581
449,1571.9619326500774,1445,1957.4175824176054,15.719619326500775,19.574175824176056,557,610,380,1547,36.005171299288946,39.431157078215904,24.56367162249515,483,698,366,1547,31.221719457013574,45.11958629605689,23.65869424692954
450,9471.875,1447,41477.16726547157,94.71875,414.77167265471576,174,191,2713,3078,5.653021442495127,6.205328135152696,88.14165042235219,763,2027,288,3078,24.788823911630928,65.85445094217025,9.35672514619883
451,5868.203125,1451,3844.3005181347567,58.68203125,38.443005181347566,4942,4647,3228,12817,38.55816493719279,36.25653429039557,25.18530077241164,2917,4912,4988,12817,22.758835921042365,38.32410080362019,38.91706327533744
452,3707.34375,1452,5014.605263157773,37.0734375,50.14605263157773,1268,1169,2014,4451,28.487980229161984,26.26376095259492,45.248258818243094,1454,2165,832,4451,32.66681644574253,48.64075488654235,18.69242866771512
453,2403.8223140496307,1453,2863.9204545457164,24.038223140496306,28.639204545457165,4325,4257,3644,12226,35.37542941272698,34.81923769016849,29.80533289710453,3248,4886,4092,12226,26.566334042205135,39.96401112383445,33.46965483396041
454,6568.8125,1454,5095.9302325582485,65.688125,50.959302325582485,3823,3058,1921,8802,43.43331061122473,34.74210406725744,21.824585321517837,2032,3308,3462,8802,23.08566234946603,37.58236764371733,39.33197000681663
455,3395.4612005856534,1455,4080.219780219592,33.95461200585653,40.80219780219592,2243,2878,3118,8239,27.22417769146741,34.93142371647045,37.84439859206215,1658,4253,2328,8239,20.123801432212648,51.62034227454788,28.25585629323947
456,9323.499267935727,1459,10618.131868130835,93.23499267935728,106.18131868130835,3966,3985,2666,10617,37.35518508053122,37.5341433549967,25.110671564472074,3204,4757,2656,10617,30.1780163888104,44.80550061222567,25.016482998963923
457,5230.527086383937,1461,5433.463541666591,52.30527086383937,54.334635416665904,4152,4714,2845,11711,35.453846810690806,40.25275382119375,24.29339936811545,2674,5271,3766,11711,22.8332337118948,45.00896592946802,32.157800358637175
458,2954.4655929722016,1462,3595.0549450548774,29.544655929722015,35.95054945054878,1820,1726,2310,5856,31.079234972677593,29.474043715846992,39.44672131147541,1114,3556,1186,5856,19.023224043715846,60.724043715846996,20.252732240437158
459,6454.531249999925,1463,5375.865384615581,64.54531249999926,53.75865384615581,5435,6652,3709,15796,34.40744492276526,42.11192707014434,23.480628007090402,4297,5328,6171,15796,27.203089389718915,33.73005824259307,39.06685236768802
460,5416.504854368935,1464,23994.342960452286,54.16504854368935,239.94342960452286,126,139,2807,3072,4.1015625,4.524739583333334,91.37369791666666,276,2569,227,3072,8.984375,83.62630208333334,7.389322916666667
461,10006.368960468977,1465,8810.142857142308,100.06368960468977,88.10142857142307,4912,6306,3308,14526,33.815227867272476,43.41181330028914,22.772958832438388,4916,5797,3813,14526,33.84276469778328,39.9077516177888,26.249483684427922
462,4267.083333333379,1466,3976.4423076918733,42.670833333333796,39.76442307691873,6914,7209,4473,18596,37.18003871800387,38.76640137664013,24.05355990535599,5863,6363,6370,18596,31.528285652828565,34.21703592170359,34.254678425467844
463,3959.7619047620956,1469,4075.0495049503634,39.59761904762095,40.750495049503634,3790,3971,2722,10483,36.15377277496899,37.8803777544596,25.9658494705714,3644,3630,3209,10483,34.76104168654011,34.62749213011542,30.61146618334446
464,5948.958333333374,1474,4832.985437061225,59.48958333333374,48.329854370612246,5237,4108,3302,12647,41.40902980944097,32.48201154423974,26.108958646319287,2797,5151,4699,12647,22.11591681821776,40.72902664663556,37.15505653514668
465,12478.902627511665,1475,8032.564841498736,124.78902627511665,80.32564841498737,5477,3698,2561,11736,46.66837082481254,31.509884117246077,21.821745057941378,2629,4856,4251,11736,22.401158827539195,41.376959781867754,36.22188139059305
466,7487.499999999697,1476,3829.5192307687053,74.87499999999697,38.29519230768705,10370,10941,2742,24053,43.11312518188999,45.48704943250323,11.399825385606785,6630,6756,10667,24053,27.56412921465098,28.087972394295928,44.34789839105309
467,3638.1405563689436,1479,4825.824175824011,36.381405563689434,48.25824175824011,2298,2364,2269,6931,33.15538883278026,34.10763237628048,32.73697879093926,1883,3439,1609,6931,27.16779685471072,49.61765978935219,23.214543355937096
468,2916.471449487557,1483,3477.747252747251,29.16471449487557,34.77747252747251,216,212,393,821,26.30937880633374,25.82216808769793,47.868453105968335,194,345,282,821,23.629719853836782,42.02192448233861,34.348355663824606
469,8345.83333333333,1486,35246.73721340383,83.4583333333333,352.4673721340383,157,169,2218,2544,6.171383647798742,6.6430817610062896,87.18553459119497,767,1544,233,2544,30.14937106918239,60.691823899371066,9.15880503144654
470,6628.611111111108,1487,31552.38095238093,66.28611111111108,315.5238095238093,135,140,1831,2106,6.41025641025641,6.647673314339982,86.94207027540361,653,1210,243,2106,31.00664767331434,57.45489078822412,11.538461538461538
471,9105.856515373553,1488,6362.362637362455,91.05856515373553,63.623626373624546,3236,3278,2208,8722,37.101582205916074,37.58312313689521,25.31529465718872,2357,3449,2916,8722,27.023618436138502,39.543682641595964,33.43269892226554
472,3504.3125,1489,2931.5116279070708,35.043125,29.315116279070708,4973,4709,3020,12702,39.15131475358211,37.07290190521178,23.775783341206107,2826,4771,5105,12702,22.248464808691544,37.56101401354117,40.19052117776728
473,7425.622254758789,1490,6114.843749999914,74.25622254758788,61.14843749999913,4736,4349,2961,12046,39.31595550390171,36.10327079528474,24.58077370081355,3386,5304,3356,12046,28.108915822679727,44.03121368088993,27.85987049643035
474,1677.8645833332891,1493,2875.769230769043,16.77864583333289,28.75769230769043,3135,3049,3457,9641,32.517373716419456,31.625350067420392,35.85727621616015,3024,4438,2179,9641,31.366040867129968,46.03256923555647,22.601389897313556
475,8277.08508845754,1495,4486.489252814697,82.7708508845754,44.86489252814697,8000,8594,7159,23753,33.679956216056915,36.18069296509914,30.139350818843937,5152,6462,12139,23753,21.689891803140657,27.204984633519974,51.10512356333937
476,5781.844802342982,1497,7600.961538461119,57.818448023429816,76.0096153846112,3899,4581,3269,11749,33.185803047067836,38.990552387437226,27.823644565494938,3876,4630,3243,11749,32.99004170567708,39.40760915822623,27.602349136096688
477,5102.415812591637,1499,4156.2500000000755,51.02415812591637,41.56250000000075,3682,3029,3374,10085,36.509667823500244,30.034705007436784,33.455627169062964,2791,3956,3338,10085,27.67476450173525,39.22657411998017,33.09866137828458
478,5254.39238653022,1500,3936.813186812974,52.543923865302204,39.36813186812974,5939,3979,3452,13370,44.420344053851906,29.760658189977562,25.818997756170532,2787,5530,5053,13370,20.845175766641734,41.361256544502616,37.793567688855646
479,7066.398243045837,1502,7848.489010988661,70.66398243045838,78.4848901098866,3500,3496,2010,9006,38.862980235398624,38.81856540084388,22.318454363757496,3103,3316,2587,9006,34.45480790584055,36.819897845880526,28.725294248278928
480,4712.518301610622,1504,5781.456043955803,47.12518301610622,57.81456043955803,2221,2095,3489,7805,28.45611787315823,26.841768097373482,44.70211402946829,2263,4096,1446,7805,28.994234465086482,52.4791800128123,18.526585522101215
481,5644.289897511092,1505,6140.109890109565,56.44289897511092,61.40109890109565,3480,3744,4499,11723,29.68523415507976,31.937217435809945,38.3775484091103,3319,5658,2746,11723,28.311865563422334,48.26409622110381,23.424038215473857
482,7555.344070278421,1506,5615.247252746856,75.55344070278421,56.15247252746856,3983,3522,2126,9631,41.356037794621535,36.569411276087635,22.074550929290833,3389,3614,2628,9631,35.188453950783924,37.52465995223756,27.286886096978506
483,4482.265625,1508,4687.063389392103,44.82265625,46.87063389392103,3779,3569,5239,12587,30.023039644077222,28.354651624692146,41.62230873123063,2400,4967,5220,12587,19.067291650115198,39.46134901088424,41.47135933900056
484,3426.6875,1510,4296.09195402305,34.266875,42.9609195402305,1935,1905,1786,5626,34.39388553146107,33.860646996089585,31.74546747244934,1525,2657,1444,5626,27.10629221471738,47.227159616068256,25.66654816921436
485,16008.28125,1512,3840.9552845525477,160.0828125,38.409552845525475,7432,8659,1946,18037,41.20419138437656,48.006874757443036,10.788933858180407,4101,4360,9576,18037,22.736596995065696,24.172534235183235,53.09086876975107
486,5772.65625,1513,5241.666662167288,57.7265625,52.41666662167288,3654,3643,2991,10288,35.517107309486775,35.4101866251944,29.07270606531882,2902,3772,3614,10288,28.207620528771383,36.66407465007776,35.128304821150856
487,5668.055555555553,1514,28141.36342244622,56.68055555555553,281.41363422446216,141,135,1666,1942,7.260556127703399,6.951596292481978,85.78784757981462,679,1028,235,1942,34.96395468589083,52.9351184346035,12.100926879505664
488,5498.609077599106,1515,5294.140624999983,54.98609077599106,52.94140624999983,3304,4211,3502,11017,29.990015430698016,38.222746664246166,31.78723790505582,3497,4101,3419,11017,31.741853499137697,37.22428973404738,31.03385676681492
489,7786.530014641691,1519,7835.439560439325,77.86530014641691,78.35439560439325,3349,4176,2022,9547,35.07908243427254,43.74148947313292,21.17942809259453,3439,3585,2523,9547,36.02178694877972,37.55106316120247,26.42714989001781
490,15069.765625,1520,12470.469202602035,150.69765625,124.70469202602035,8318,9044,4525,21887,38.00429478685978,41.321332297710974,20.674372915429252,7391,7861,6635,21887,33.76890391556632,35.91629734545621,30.314798738977476
491,2982.5929752066195,1523,2291.382575757714,29.825929752066195,22.913825757577143,3176,2672,2300,8148,38.97889052528228,32.793323514973,28.227785959744722,1846,3262,3040,8148,22.65586647029946,40.034364261168385,37.30976926853216
492,5831.25,1524,4556.639247943627,58.3125,45.566392479436274,3866,4254,3137,11257,34.34307541973883,37.78981966776228,27.867104912498892,2850,3820,4587,11257,25.317580172337212,33.93444079239584,40.747979035266944
493,4517.699579831576,1525,2340.0961538459433,45.17699579831576,23.400961538459434,5674,6164,2921,14759,38.444339047360934,41.76434717799309,19.791313774645978,3586,5033,6140,14759,24.297039094789618,34.1012263703503,41.601734534860086
494,8051.098096633149,1526,7476.3736263731025,80.51098096633149,74.76373626373102,4493,4385,2635,11513,39.025449491878746,38.08737948406149,22.887171024059757,2970,5131,3412,11513,25.796925214974376,44.56701120472509,29.63606358030053
495,5328.989751098605,1527,7113.736263735658,53.289897510986044,71.13736263735659,3224,3722,2632,9578,33.66047191480476,38.85988724159532,27.479640843599917,2948,4293,2337,9578,30.77886823971602,44.821465859260805,24.39966590102318
496,6270.497803807221,1528,8032.162921348684,62.70497803807221,80.32162921348684,2622,3214,2865,8701,30.134467302608897,36.938282955982075,32.92724974140903,4638,2137,1926,8701,53.30421790598782,24.560395356855533,22.135386737156647
497,7987.188872620889,1529,6372.115384615338,79.8718887262089,63.721153846153385,974,1078,628,2680,36.343283582089555,40.223880597014926,23.432835820895523,1020,989,671,2680,38.059701492537314,36.90298507462686,25.037313432835823
498,1035.5555555555554,1530,4249.03536977492,10.355555555555554,42.4903536977492,11,15,120,146,7.534246575342466,10.273972602739725,82.1917808219178,17,110,19,146,11.643835616438356,75.34246575342466,13.013698630136986
499,3722.9687500000346,1531,3026.442307692103,37.229687500000345,30.26442307692103,4064,3824,2670,10558,38.4921386626255,36.218980867588556,25.288880469785944,2920,4363,3275,10558,27.656753172949422,41.32411441560902,31.019132411441564
500,4996.967741935235,1532,3511.910377358713,49.969677419352344,35.11910377358713,4394,4260,3152,11806,37.2183635439607,36.08334745044892,26.698289005590375,1914,4228,5664,11806,16.21209554463832,35.81229883110283,47.97560562425885
501,5781.551976574275,1533,7045.192307691996,57.81551976574275,70.45192307691995,3855,3494,2673,10022,38.465376172420676,34.86330073837557,26.671323089203753,2843,4238,2941,10022,28.367591299141885,42.28696866892836,29.345440031929755
502,5432.357247437955,1535,4172.802197802036,54.32357247437955,41.72802197802036,3260,3650,2221,9131,35.70255174679663,39.973715912824446,24.32373234037893,1955,3898,3278,9131,21.41057934508816,42.68973825429854,35.8996824006133
503,3833.9677891654637,1536,4052.604166666713,38.33967789165464,40.526041666667126,1656,1919,1943,5518,30.010873504893077,34.777093149691915,35.21203334541501,972,2731,1815,5518,17.615077926785066,49.4925697716564,32.89235230155854
504,6689.458272328042,1537,7621.565934065787,66.89458272328042,76.21565934065787,2310,2378,9973,14661,15.756087579292,16.2199031443967,68.0240092763113,2430,3579,8652,14661,16.574585635359114,24.41170452220176,59.01370984243912
505,4241.142020497868,1538,4931.5934065932115,42.411420204978675,49.31593406593211,2739,3036,1801,7576,36.153643083421336,40.07391763463569,23.77243928194298,2143,3781,1652,7576,28.286694825765572,49.90760295670539,21.80570221752904
506,3730.5354558609224,1539,5035.349462365815,37.305354558609224,50.35349462365815,3321,2511,2786,8618,38.5356231144117,29.136690647482016,32.32768623810629,3793,2427,2398,8618,44.012531909955904,28.161986539800417,27.825481550243676
507,5198.0966325040545,1540,6499.038461537899,51.98096632504055,64.99038461537899,5218,4731,3785,13734,37.99330129605359,34.44735692442114,27.559341779525266,4503,5986,3245,13734,32.78724333770205,43.58526285131789,23.62749381098005
508,4261.177696717054,1541,2503.3563672259925,42.611776967170535,25.033563672259923,4954,6761,5375,17090,28.987712112346404,39.56114686951434,31.45114101813926,3043,4680,9367,17090,17.80573434757168,27.38443534230544,54.80983031012288
509,3205.9297218155552,1542,4664.697802197645,32.05929721815555,46.646978021976444,2572,2295,2699,7566,33.99418450964843,30.333068992862806,35.67274649748877,1438,4467,1661,7566,19.0060798308221,59.04044409199049,21.953476077187418
510,9527.1875,1543,6861.0465116280475,95.271875,68.61046511628048,7264,8634,2987,18885,38.46438972729679,45.71882446386021,15.816785808842997,5491,6466,6928,18885,29.075986232459623,34.238813873444535,36.685199894095845
511,9632.576866764577,1544,8672.527472526925,96.32576866764578,86.72527472526924,5149,4859,2339,12347,41.702437839151216,39.35368915526038,18.9438730055884,3864,4774,3709,12347,31.295051429497043,38.665262816878595,30.03968575362436
512,12371.1287988403,1546,9721.811224488572,123.711287988403,97.21811224488573,6510,6956,3277,16743,38.88192080272353,41.545720599653585,19.572358597622888,4138,6235,6370,16743,24.714806187660514,37.23944334945948,38.04575046288001
513,8312.977099236625,1547,43510.69511040305,83.12977099236625,435.10695110403054,212,227,3038,3477,6.097210238711533,6.528616623526028,87.37417313776244,1772,1357,348,3477,50.96347425941904,39.02789761288467,10.008628127696289
514,7438.06734992738,1549,5507.142857142342,74.3806734992738,55.07142857142342,5056,5141,2758,12955,39.027402547279046,39.68351987649556,21.289077576225395,2890,4968,5097,12955,22.307989193361635,38.34812813585488,39.34388267078348
515,3118.9453125,1551,3981.6358024691353,31.189453125,39.816358024691354,127,123,379,629,20.190779014308426,19.554848966613672,60.254372019077906,57,330,242,629,9.062003179650238,52.46422893481717,38.47376788553259
516,3378.5937500000623,1553,2584.2374616170146,33.78593750000062,25.842374616170147,5867,4987,5200,16054,36.54540924380217,31.06390930609194,32.39068145010589,3486,4351,8217,16054,21.714214525974835,27.10227980565591,51.18350566836926
517,16676.275303645285,1554,12801.575931233601,166.76275303645286,128.015759312336,5293,5564,2941,13798,38.360631975648644,40.32468473691839,21.314683287432963,2962,5348,5488,13798,21.466879257863457,38.75924046963328,39.77388027250326
518,6109.809663250366,1557,3772.93956043956,61.098096632503655,37.7293956043956,142,158,520,820,17.317073170731707,19.26829268292683,63.41463414634146,122,410,288,820,14.878048780487804,50.0,35.12195121951219
519,7619.985358712143,1558,5272.252747252469,76.19985358712144,52.72252747252469,6132,5733,3100,14965,40.97560975609756,38.309388573337785,20.71500167056465,3776,4867,6322,14965,25.232208486468426,32.5225526227865,42.24523889074507
520,1850.5475989890463,1560,1542.5126903553291,18.505475989890463,15.425126903553291,76,52,109,237,32.06751054852321,21.940928270042196,45.9915611814346,74,121,42,237,31.223628691983123,51.0548523206751,17.72151898734177
521,4739.127604166616,1562,5182.2815541794125,47.39127604166616,51.82281554179413,4939,4536,4167,13642,36.20436886087084,33.25025656062161,30.545374578507552,3632,5450,4560,13642,26.62366221961589,39.95015393637297,33.42618384401114
522,2593.551491819145,1564,1270.3537338573637,25.93551491819145,12.703537338573637,2050,2050,2978,7078,28.9629838937553,28.9629838937553,42.074032212489406,1957,3433,1688,7078,27.649053404916646,48.50240180842046,23.8485447866629
523,4345.469083155428,1566,2787.4455732949423,43.45469083155428,27.87445573294942,5614,5200,3884,14698,38.195672880664034,35.378963124234595,26.425363995101375,3927,5396,5375,14698,26.717920805551778,36.71247788814805,36.56960130630018
524,4864.494875549249,1567,6350.412087911761,48.644948755492486,63.50412087911761,3015,3825,2558,9398,32.08129389231751,40.7001489678655,27.218557139816983,3262,4156,1980,9398,34.709512662268565,44.22217493083635,21.068312406895085
525,3755.2777777775354,1568,4530.1745635910465,37.552777777775354,45.301745635910464,3476,2634,6042,12152,28.604344963791966,21.675444371296905,49.72021066491112,2068,4909,5175,12152,17.017774851876236,40.39664252797893,42.58558262014483
526,5909.004392386767,1571,6707.142857142665,59.09004392386767,67.07142857142665,2682,2749,1655,7086,37.84928027095681,38.79480666102174,23.35591306802145,2264,2935,1887,7086,31.95032458368614,41.41970081851538,26.62997459779848
527,4033.601756954597,1572,4249.457994580131,40.33601756954597,42.494579945801306,3234,3042,2681,8957,36.10583900859663,33.9622641509434,29.931896840459977,1616,4126,3215,8957,18.041755051914706,46.06453053477727,35.893714413308025
528,14740.40995607595,1576,10372.527472526568,147.4040995607595,103.72527472526568,4628,4657,2503,11788,39.260264675941634,39.50627757041059,21.233457753647777,3430,3616,4742,11788,29.097387173396676,30.67526297930098,40.22734984730234
529,4301.244509516837,1580,3268.8186813186912,43.01244509516837,32.68818681318691,115,132,560,807,14.250309789343246,16.356877323420075,69.39281288723667,173,385,249,807,21.437422552664188,47.70755885997522,30.855018587360593
530,4827.0588235295245,1581,5740.384615384504,48.27058823529524,57.403846153845045,2987,3124,1935,8046,37.12403678846632,38.826746209296545,24.049217002237135,2606,3635,1805,8046,32.3887646035297,45.177728063634106,22.433507332836193
531,9105.003088326512,1583,7581.826923078633,91.05003088326512,75.81826923078633,10580,9103,5096,24779,42.69744541749061,36.73675289559708,20.565801686912305,7030,8531,9218,24779,28.3707978530207,34.4283465838008,37.2008555631785
532,9434.444444444443,1584,48779.28550830907,94.34444444444443,487.79285508309067,167,184,5248,5599,2.982675477763886,3.2863011252009287,93.73102339703519,1852,3500,247,5599,33.07733523843544,62.51116270762637,4.411502053938203
533,3534.895833333387,1585,2890.673076922867,35.34895833333387,28.90673076922867,4030,4649,4206,12885,31.276678308110206,36.08071400853706,32.642607683352736,2702,4787,5396,12885,20.97012029491657,37.151726814124956,41.87815289095848
534,6453.1875,1588,4944.36781609245,64.531875,49.4436781609245,5959,5826,3308,15093,39.48187901676274,38.600675809978135,21.917445173259125,3604,5326,6163,15093,23.878619227456436,35.287881799509705,40.833498973033855
535,6000.14471779989,1589,4218.682795699002,60.0014471779989,42.186827956990015,6377,6053,3344,15774,40.4272854063649,38.37327247369088,21.199442119944212,3239,5999,6536,15774,20.533789780651706,38.030936984911875,41.435273234436416
536,6929.428989751378,1591,8142.032967032712,69.29428989751378,81.42032967032712,3283,3260,2941,9484,34.61619569801771,34.37368199072122,31.010122311261075,3297,4463,1724,9484,34.76381273724167,47.05820328975116,18.17798397300717
537,5779.941434846538,1592,6005.082417581648,57.799414348465376,60.05082417581648,4162,4124,4083,12369,33.648637723340606,33.34141806128223,33.00994421537715,2705,5604,4060,12369,21.869189101786727,45.30681542566093,32.82399547255235
538,10881.403762660611,1593,7433.870967743832,108.81403762660611,74.33870967743832,9955,10612,6275,26842,37.08740034274644,39.53505700022353,23.37754265703003,7504,9564,9774,26842,27.9561880634826,35.630727963639075,36.413083972878326
539,5197.19142645935,1594,3435.3477765106213,51.971914264593494,34.35347776510621,5632,4448,6691,16771,33.581778069286266,26.521972452447677,39.89624947826606,2499,4638,9634,16771,14.900721483513207,27.654880448393058,57.44439806809374
540,22062.177985947863,1595,196732.35292797902,220.62177985947864,1967.3235292797901,4377,3942,7927,16246,26.94201649636834,24.26443432229472,48.79354918133694,6518,8154,1574,16246,40.12064508186631,50.190816200910994,9.688538717222702
541,14787.53387533903,1596,9959.491525423839,147.8753387533903,99.59491525423839,2375,2462,2332,7169,33.12874877946715,34.342307155809735,32.52894406472311,2235,2965,1969,7169,31.1758962198354,41.35862742362952,27.465476356535078
542,inf,1597,inf,inf,inf,12,4,0,16,75.0,25.0,0.0,18,0,0,18,100.0,0.0,0.0
543,8078.211805556024,1598,6955.483892183937,80.78211805556025,69.55483892183938,2876,2984,2002,7862,36.58102264054948,37.954718901042995,25.464258458407528,2683,3337,1842,7862,34.12617654540829,42.444670567285684,23.429152887306028
544,12532.44514106395,1600,10773.108108106315,125.3244514106395,107.73108108106315,8340,5726,3902,17968,46.41585040071238,31.867764915405168,21.71638468388246,6191,6584,5193,17968,34.45569902048086,36.642920747996435,28.901380231522705
545,11841.323529411518,1601,9115.247252746301,118.41323529411518,91.15247252746302,6105,6470,2617,15192,40.18562401263823,42.58820431806214,17.22617166929963,4135,4840,6217,15192,27.218272775144815,31.85887309110058,40.92285413375461
546,134.16666666666652,1605,280.28571428571416,1.3416666666666652,2.8028571428571416,100,145,92,337,29.673590504451035,43.02670623145401,27.299703264094955,155,75,107,337,45.99406528189911,22.255192878338278,31.750741839762615
547,5997.950219619622,1606,3891.07142857122,59.979502196196215,38.9107142857122,4747,3991,2220,10958,43.3199488957839,36.42087972257711,20.259171381638986,1853,4238,4867,10958,16.910020076656323,38.67494068260631,44.41503924073736
548,10178.654124456982,1607,11063.306451613284,101.78654124456982,110.63306451613283,2722,2718,1214,6654,40.90772467688608,40.84761045987376,18.244664863240157,1918,2702,2034,6654,28.82476705740908,40.60715359182447,30.568079350766457
549,4740.429687500031,1611,5740.64356517948,47.40429687500031,57.4064356517948,2524,2224,2256,7004,36.03655054254711,31.75328383780697,32.21016561964591,1943,3241,1820,7004,27.741290691033694,46.27355796687607,25.985151342090234
550,8803.806734993148,1612,7453.159340658657,88.03806734993148,74.53159340658657,5050,5770,4012,14832,34.04800431499461,38.90237324703344,27.049622437971955,4196,4948,5688,14832,28.29018338727077,33.36030204962243,38.349514563106794
551,1837.9166666666326,1613,4337.211538461336,18.379166666666325,43.37211538461336,1978,2329,2562,6869,28.79604018052118,33.90595428737807,37.298005532100746,2331,3323,1215,6869,33.93507060707527,48.37676517688164,17.68816421604309
552,7040.483162518636,1615,7830.906593406021,70.40483162518636,78.30906593406021,3525,4242,3923,11690,30.15397775876818,36.287425149700596,33.558597091531226,3317,4702,3671,11690,28.37467921300257,40.222412318220705,31.40290846877673
553,1039.385065885793,1616,1275.0000000000045,10.39385065885793,12.750000000000046,364,427,184,975,37.333333333333336,43.794871794871796,18.871794871794872,318,463,194,975,32.61538461538461,47.48717948717949,19.897435897435898
554,5957.174231332919,1617,7646.016483515866,59.57174231332919,76.46016483515865,3011,3117,3829,9957,30.240032138194234,31.304609822235612,38.45535803957015,2668,5531,1758,9957,26.79521944360751,55.548860098423226,17.65592045796927
555,2763.984375,1618,3153.421052631578,27.63984375,31.53421052631578,109,136,285,530,20.566037735849058,25.660377358490567,53.77358490566038,83,195,252,530,15.660377358490566,36.79245283018868,47.54716981132076
556,7207.8709677413,1620,7603.8186157510345,72.078709677413,76.03818615751034,5227,4667,5295,15189,34.41306208440319,30.726183422213442,34.86075449338337,4189,5466,5534,15189,27.57916913555863,35.9865692277306,36.43426163671078
557,5490.554254488876,1622,5553.701380175946,54.90554254488876,55.53701380175946,3036,2440,9718,15194,19.981571673028828,16.058970646307753,63.95945768066342,1887,3326,9981,15194,12.41937606950112,21.890219823614583,65.69040410688429
558,19195.703125,1623,16251.781766491695,191.95703125,162.51781766491695,4163,4522,3872,12557,33.15282312654296,36.01178625467866,30.83539061877837,3612,5680,3265,12557,28.764832364418254,45.233734172174884,26.001433463406865
559,2263.791322314101,1625,2973.958333333544,22.63791322314101,29.73958333333544,2858,2753,3049,8660,33.00230946882217,31.789838337182445,35.20785219399538,2611,4205,1844,8660,30.150115473441108,48.556581986143186,21.293302540415702
560,7161.875,1626,6440.776699029428,71.61875,64.40776699029428,4695,4858,5551,15104,31.08448093220339,32.16366525423729,36.75185381355932,3331,5095,6678,15104,22.05376059322034,33.73278601694915,44.21345338983051
561,4514.285714285458,1627,3173.450413223302,45.14285714285458,31.73450413223302,5351,5054,3182,13587,39.38323397365128,37.1973209685729,23.419445057775814,3050,5001,5536,13587,22.447928166629865,36.8072422168249,40.744829616545225
562,4071.953125,1629,4301.117886178603,40.71953125,43.01117886178603,3594,3932,3724,11250,31.94666666666667,34.95111111111111,33.102222222222224,3590,4812,2848,11250,31.91111111111111,42.77333333333333,25.31555555555556
563,8647.935973040847,1630,5404.722226327634,86.47935973040848,54.047222263276346,6461,8028,3725,18214,35.472713297463486,44.07598550565499,20.45130119688152,2905,5913,9396,18214,15.949269792467332,32.46403865158669,51.586691555945976
564,6182.78816199408,1631,4923.711340206394,61.8278816199408,49.23711340206394,4054,4063,2709,10826,37.44688712359135,37.53002032144836,25.02309255496028,2342,4489,3995,10826,21.63310548679106,41.464991686680214,36.901902826528726
565,7367.5,1632,4614.73684210493,73.675,46.14736842104929,4592,5277,3241,13110,35.02669717772693,40.25171624713959,24.721586575133486,2961,4118,6031,13110,22.585812356979403,31.41113653699466,46.003051106025936
566,7902.222222222222,1633,36373.166023166,79.02222222222221,363.73166023166,157,158,3314,3629,4.326260677872693,4.353816478368697,91.31992284375862,1380,2014,235,3629,38.02700468448608,55.497382198952884,6.475613116561036
567,4018.2851239668703,1635,4307.786116323072,40.1828512396687,43.07786116323072,5748,4491,2523,12762,45.039962388340385,35.19040902679831,19.769628584861305,4304,4375,4083,12762,33.7251214543175,34.28146058611503,31.993417959567466
568,10430.89311859469,1636,9951.785714284584,104.30893118594689,99.51785714284584,4415,4790,2926,12131,36.39436155304592,39.48561536559229,24.1200230813618,3472,5439,3220,12131,28.620888632429313,44.83554529717254,26.543566070398157
569,3830.7812500000227,1638,3571.1538461533764,38.307812500000225,35.71153846153376,5381,6447,3669,15497,34.72284958379041,41.60160030973737,23.675550106472222,4982,6640,3875,15497,32.148157707943476,42.847002645673356,25.00483964638317
570,13671.669106881482,1639,10256.043956043768,136.7166910688148,102.56043956043769,1509,1551,1104,4164,36.23919308357348,37.247838616714695,26.512968299711815,1568,1700,896,4164,37.656099903938525,40.82612872238233,21.517771373679153
571,3116.6666666666015,1640,4102.209302325602,31.166666666666014,41.02209302325602,1982,1869,1983,5834,33.973260198834424,32.0363387041481,33.99040109701749,1994,2693,1147,5834,34.1789509770312,46.16043880699349,19.660610215975318
572,7433.016105417372,1641,6892.307692307631,74.33016105417373,68.92307692307631,1639,1659,894,4192,39.098282442748086,39.57538167938932,21.326335877862597,1518,1696,978,4192,36.211832061068705,40.458015267175576,23.330152671755723
573,17902.38784370364,1642,12487.76881720538,179.0238784370364,124.87768817205381,7626,7450,2435,17511,43.54976871680658,42.544686197247444,13.905545085945977,4705,5907,6899,17511,26.868825309805267,33.733082062703446,39.398092627491295
574,1185.000000000003,1643,1206.868131868135,11.85000000000003,12.06868131868135,397,399,223,1019,38.959764474975465,39.15603532875368,21.884200196270854,363,372,284,1019,35.62315996074583,36.50637880274779,27.870461236506376
575,4761.928571428528,1644,2755.0741163053995,47.619285714285276,27.550741163053996,4060,4284,4537,12881,31.519291980436304,33.258287400046584,35.222420619517116,1819,4603,6459,12881,14.12157441192454,35.73480319850943,50.14362238956602
576,7681.380208333591,1646,6215.485436201597,76.81380208333591,62.15485436201597,6913,5809,4011,16733,41.313571983505646,34.71583099264925,23.970597023845098,4796,5493,6444,16733,28.661925536365267,32.82734715830993,38.51072730532481
577,8313.10395314818,1647,7105.631868131357,83.1310395314818,71.05631868131357,4551,4137,2026,10714,42.4771327235393,38.61302968079149,18.909837595669217,2542,4344,3828,10714,23.725966025760687,40.54508120216539,35.728952772073924
578,3871.484375,1648,3869.375,38.71484375,38.69375,3314,3163,4500,10977,30.190398105128907,28.81479457046552,40.99480732440558,2306,4392,4279,10977,21.00756126446206,40.01093194861984,38.981506786918104
579,5002.12298682285,1649,6824.728260869619,50.0212298682285,68.24728260869618,816,832,1637,3285,24.840182648401825,25.327245053272453,49.83257229832572,714,1758,813,3285,21.735159817351597,53.51598173515981,24.748858447488583
580,10419.83894582752,1651,7557.554945054481,104.1983894582752,75.57554945054481,7274,8316,3202,18792,38.70796083439762,44.252873563218394,17.039165602383992,4147,4789,9856,18792,22.067901234567902,25.484248616432524,52.44785014899958
581,10965.55153707004,1653,6417.983193277371,109.6555153707004,64.17983193277371,2702,3372,3548,9622,28.08147994180004,35.044689253793386,36.87383080440657,2053,3399,4170,9622,21.336520473913946,35.325296196217,43.338183329869054
582,3452.5174283499255,1654,2925.1930501929105,34.525174283499254,29.251930501929106,2852,3038,1884,7774,36.68639053254438,39.078981219449446,24.234628248006175,2195,3543,2036,7774,28.23514278363777,45.574993568304606,26.189863648057628
583,6943.631039531973,1655,5989.423076922451,69.43631039531974,59.894230769224514,4711,5309,3925,13945,33.78271782000717,38.07099318752241,28.14628899247042,4601,4939,4405,13945,32.99390462531373,35.41771244173539,31.588382932950875
584,7409.6875,1656,6507.441860465156,74.096875,65.07441860465157,5405,5894,2635,13934,38.79001004736615,42.29941151141094,18.91057844122291,3190,4222,6522,13934,22.89364145256208,30.29998564661978,46.80637290081815
585,3647.7306002928253,1657,4542.032967032834,36.47730600292825,45.420329670328336,2663,2378,2184,7225,36.858131487889274,32.91349480968858,30.228373702422147,1898,3722,1605,7225,26.269896193771626,51.51557093425606,22.214532871972317
586,13382.549019608276,1658,7262.969588551256,133.82549019608277,72.62969588551256,2601,2819,4029,9449,27.52672240448725,29.833844851307017,42.639432744205735,3058,4532,1859,9449,32.36321303841677,47.962747380675204,19.67403958090803
587,7376.432291666948,1661,5949.282405870917,73.76432291666949,59.49282405870917,5709,7187,3439,16335,34.94949494949495,43.99755127027854,21.052953780226506,3899,5244,7192,16335,23.868992959902048,32.102846648301195,44.02816039179675
588,4672.840409956214,1662,4929.807692307433,46.72840409956214,49.29807692307433,2837,2815,2750,8402,33.76577005474887,33.503927636277076,32.73030230897405,2212,4056,2134,8402,26.327064984527492,48.27422042370864,25.398714591763866
589,2666.640625,1663,3116.565040650185,26.66640625,31.16565040650185,3389,2874,2774,9037,37.50138320239017,31.802589354874407,30.696027442735417,2655,4380,2002,9037,29.379218767290027,48.46741175168751,22.153369481022462
590,9716.11111111111,1667,51234.507042253594,97.1611111111111,512.345070422536,222,250,2447,2919,7.605344295991778,8.564576909900651,83.83007879410758,1546,1043,330,2919,52.96334361082563,35.73141486810552,11.30524152106886
591,4044.774193548283,1668,3138.424821002519,40.44774193548283,31.384248210025188,3286,2948,2312,8546,38.450737186988064,34.495670489117714,27.05359232389422,1318,4054,3174,8546,15.422419845541773,47.437397612918325,37.1401825415399
592,7556.625,1669,5975.232558139562,75.56625,59.75232558139562,4134,3982,1460,9576,43.17042606516291,41.58312447786132,15.246449456975771,2439,3369,3768,9576,25.469924812030076,35.18170426065163,39.34837092731829
593,5272.34375,1670,4674.105865522251,52.7234375,46.74105865522252,3555,3543,4372,11470,30.993897122929383,30.88927637314734,38.11682650392328,2482,4164,4824,11470,21.63905841325196,36.303400174367916,42.057541412380125
594,8450.541795665826,1671,5997.854077252988,84.50541795665826,59.978540772529875,8490,7838,5628,21956,38.66824558207323,35.69867006740754,25.63308435051922,5764,4669,11523,21956,26.252505010020037,21.26525778830388,52.48223720167607
595,2888.1547619049156,1673,3464.3137254900826,28.881547619049158,34.64313725490083,3517,3706,2472,9695,36.27643115007736,38.22588963383187,25.49767921609077,2798,4195,2702,9695,28.8602372356885,43.26972666322847,27.870036101083034
596,5752.058823529442,1674,6898.480662983386,57.52058823529442,68.98480662983386,1746,1865,862,4473,39.03420523138833,41.69461211714733,19.27118265146434,1786,2002,685,4473,39.928459646769504,44.75743348982786,15.314106863402637
597,6272.547584187791,1678,7699.999999999756,62.72547584187791,76.99999999999756,3729,4470,3546,11745,31.749680715197957,38.05874840357599,30.191570881226053,3395,5556,2794,11745,28.90591741166454,47.30523627075351,23.78884631758195
598,4452.847222222022,1679,3322.0183486238893,44.528472222220216,33.220183486238895,3555,3324,2164,9043,39.312175163109586,36.7577131482915,23.930111688598917,1733,3897,3413,9043,19.163994249695897,43.09410593829482,37.74189981200929
599,4393.85065885801,1680,4634.752747252756,43.938506588580104,46.34752747252756,1460,1148,706,3314,44.055522027761015,34.640917320458655,21.303560651780327,1467,1255,592,3314,44.26674713337357,37.869643934821966,17.863608931804468
600,4277.083333333377,1681,2699.904761904573,42.77083333333377,26.999047619045733,5165,5986,2400,13551,38.115268245885915,44.173861707623054,17.710870046491035,3022,4379,6150,13551,22.300937200206626,32.3149583056601,45.384104494133275
601,5961.25,1683,5029.651162790753,59.6125,50.29651162790753,3772,4107,2070,9949,37.91335812644487,41.28053070660368,20.806111166951453,2542,3339,4068,9949,25.55030656347372,33.56116192582169,40.888531510704595
602,4521.927083333353,1684,5107.788461538464,45.21927083333353,51.07788461538464,5274,4927,2451,12652,41.68510907366424,38.94245969016757,19.372431236168193,3469,4760,4423,12652,27.418589946253558,37.622510275055326,34.95889977869112
603,4762.0058565155505,1685,5514.423076922709,47.6200585651555,55.144230769227086,4252,3947,2110,10309,41.24551362886798,38.28693374721118,20.467552623920845,2329,5237,2743,10309,22.5919099815695,50.8002716073334,26.6078184110971
604,4589.74609375,1686,4752.439024390286,45.8974609375,47.524390243902864,840,1298,1441,3579,23.47024308466052,36.2671137189159,40.26264319642358,582,1798,1199,3579,16.261525565800504,50.2374965074043,33.500977926795194
605,11320.902777778276,1687,9118.688118809854,113.20902777778275,91.18688118809854,8567,8928,8851,26346,32.51727017384043,33.88749715326805,33.59523267289152,5827,7211,13308,26346,22.117209443558792,27.370378805131708,50.51241175130949
606,4645.703125,1688,4824.417009602064,46.45703125,48.244170096020646,3579,3310,5873,12762,28.044193700047014,25.93637360915217,46.01943269080081,1946,5098,5718,12762,15.248393668703967,39.946716815546154,44.804889515749885
607,3868.008784773061,1691,4786.401098900933,38.68008784773061,47.86401098900933,2341,2423,3142,7906,29.61042246395143,30.647609410574244,39.74196812547432,1962,4194,1750,7906,24.816594991145966,53.04831773336707,22.135087275486974
608,3573.125,1692,4181.460674157417,35.73125,41.814606741574174,1639,2194,2053,5886,27.84573564390078,37.27488956846755,34.87937478763167,1291,2855,1740,5886,21.933401291199456,48.50492694529392,29.561671763506624
609,17974.19945105201,1693,13413.402802291792,179.7419945105201,134.13402802291793,4868,4530,4840,14238,34.19019525214215,31.816266329540667,33.99353841831718,4988,4232,5018,14238,35.03301025424919,29.72327574097486,35.24371400477595
610,3079.58984375,1694,2291.346153846167,30.7958984375,22.91346153846167,786,750,485,2021,38.89163780306779,37.110341415141015,23.998020781791194,758,848,415,2021,37.506185056902524,41.95942602671945,20.53438891637803
611,5564.560862865914,1696,2916.5530671863085,55.64560862865914,29.165530671863085,4994,4091,3089,12174,41.02184984392969,33.6044028256941,25.37374733037621,3924,4263,3987,12174,32.232626909807784,35.01724987678659,32.750123213405615
612,6057.240099009496,1700,4750.684931507044,60.572400990094955,47.50684931507044,4189,3498,1940,9627,43.513036252207336,36.33530694920536,20.151656798587307,1745,4267,3615,9627,18.12610366677054,44.32325750493404,37.55063882829542
613,8990.263543192068,1701,7571.428571428376,89.90263543192069,75.71428571428376,2252,2617,1640,6509,34.59824857889077,40.205868797050236,25.195882624058996,2446,2719,1344,6509,37.578737133200185,41.7729297895222,20.648333077277616
614,6403.055555555566,1702,31894.771394815194,64.03055555555565,318.94771394815194,144,159,1947,2250,6.4,7.066666666666667,86.53333333333333,928,1072,250,2250,41.24444444444445,47.644444444444446,11.11111111111111
615,3831.25,1704,4093.5439560439504,38.3125,40.935439560439505,1197,1102,764,3063,39.07933398628795,35.97779954293176,24.94286647078028,1274,1370,419,3063,41.5932092719556,44.72739144629448,13.679399281749918
616,4260.375,1705,5670.581395348925,42.60375,56.70581395348925,2254,2338,2204,6796,33.166568569746914,34.40258975868158,32.430841671571514,2240,2773,1783,6796,32.9605650382578,40.80341377280753,26.236021188934664
617,10497.364568082157,1706,11674.862637361182,104.97364568082158,116.74862637361183,4420,4347,2989,11756,37.59782238856754,36.97686287853011,25.42531473290235,4571,4754,2431,11756,38.88227288193263,40.438924804355224,20.678802313712147
618,5769.513888888614,1707,6876.3953488373045,57.69513888888614,68.76395348837305,3106,2841,1952,7899,39.32143309279655,35.966578047854156,24.711988859349283,3395,2700,1804,7899,42.98012406633751,34.18154196733764,22.83833396632485
619,4240.972222221938,1709,2994.4127708093765,42.40972222221938,29.944127708093767,4521,4118,4698,13337,33.898178001049715,30.87650896003599,35.225313038914294,2550,4776,6011,13337,19.119742070930496,35.81015220814276,45.07010572092675
620,4013.2416787264433,1710,4952.016129032364,40.13241678726443,49.52016129032364,1880,1741,1550,5171,36.35660413846452,33.66853606652485,29.974859795010637,1868,1728,1575,5171,36.124540707793464,33.41713401663121,30.458325275575326
621,9409.999999999987,1712,37113.522537563025,94.09999999999987,371.1352253756302,166,177,3632,3975,4.176100628930818,4.452830188679245,91.37106918238995,1815,1919,241,3975,45.660377358490564,48.276729559748425,6.062893081761006
622,4877.745241581335,1713,4200.549450549268,48.77745241581335,42.00549450549268,2603,3096,3413,9112,28.566725197541704,33.977172958735736,37.456101843722564,1955,4236,2921,9112,21.455223880597014,46.488147497805095,32.056628621597895
623,7451.9444444444425,1714,37528.861032647816,74.51944444444443,375.28861032647814,156,166,3204,3526,4.424276800907544,4.707884288145207,90.86783891094726,1205,2080,241,3526,34.1747022121384,58.99035734543392,6.83494044242768
624,4517.596566523513,1715,3433.751425313429,45.175965665235125,34.33751425313429,3241,3823,3320,10384,31.211479198767332,36.81625577812018,31.972265023112477,2127,3619,4638,10384,20.48343605546995,34.85169491525424,44.66486902927581
625,7249.926793558406,1716,8033.604336043885,72.49926793558406,80.33604336043885,5043,5279,3673,13995,36.034297963558416,37.72061450518042,26.245087531261163,4578,5783,3634,13995,32.71168274383708,41.32190067881386,25.966416577349055
626,5739.65277777743,1717,5005.402010050258,57.3965277777743,50.054020100502576,3741,3661,4344,11746,31.849140132811172,31.168057210965433,36.9828026562234,2655,3893,5198,11746,22.603439468755322,33.14319768431807,44.25336284692661
627,4771.010248902022,1718,4958.928571428252,47.710102489020215,49.589285714282525,2800,2705,2957,8462,33.08910423067833,31.96643819428031,34.94445757504136,1968,4048,2446,8462,23.256913259276768,47.83739068778067,28.905696052942563
628,18551.171875,1719,12416.363634435374,185.51171875,124.16363634435375,8315,12285,3615,24215,34.33822011150113,50.733016725170344,14.928763163328515,6388,6170,11657,24215,26.380342762750363,25.480074334090443,48.1395829031592
629,5645.772357723359,1721,4153.272251308959,56.457723577233594,41.532722513089595,2246,2812,1807,6865,32.716678805535324,40.961398397669335,26.321922796795338,1892,3190,1783,6865,27.560087399854332,46.46758922068463,25.97232337946103
630,9945.38799414358,1722,7281.532355062202,99.4538799414358,72.81532355062203,1421,1860,5292,8573,16.575294529336286,21.696022395894087,61.72868307476963,1330,1779,5464,8573,15.513822465881255,20.75119561413741,63.73498191998134
631,7677.9648609081705,1723,6687.362637362241,76.7796486090817,66.87362637362241,3846,4792,1695,10333,37.22055550179038,46.37568953837221,16.403754959837414,3688,3663,2982,10333,35.6914739185135,35.44953063002032,28.858995451466175
632,1980.1652892563272,1724,2244.0340909093416,19.801652892563272,22.440340909093415,6524,6801,4604,17929,36.38797478944726,37.93295777790172,25.679067432651014,3706,6112,8111,17929,20.670422220982765,34.09002175246807,45.23955602654917
633,9794.790159188895,1725,5892.042440317931,97.94790159188895,58.92042440317931,5644,5754,2637,14035,40.21375133594585,40.99750623441397,18.788742429640184,4499,5541,3995,14035,32.05557534734592,39.47987174919843,28.464552903455647
634,4336.237188872702,1728,5404.670329670123,43.36237188872702,54.046703296701224,3373,3282,1807,8462,39.86055306074214,38.785157173245096,21.354289766012762,2611,3924,1927,8462,30.85558969510754,46.372016071850624,22.772394233041833
635,6779.609375,1729,7228.726287263828,67.79609375,72.28726287263828,5141,5788,7485,18414,27.91897469316824,31.432605626154015,40.64841968067775,4458,6123,7833,18414,24.209840338872596,33.25187357445422,42.53828608667318
636,6587.047756873852,1732,7363.306451613286,65.87047756873852,73.63306451613286,2761,2474,3053,8288,33.31322393822394,29.8503861003861,36.83638996138996,3386,3175,1727,8288,40.85424710424711,38.30839768339768,20.837355212355213
637,3437.291666666702,1734,3117.692307692141,34.37291666666702,31.176923076921412,4282,3792,2253,10327,41.46412317226687,36.71927955843904,21.816597269294082,3274,3033,4020,10327,31.70330202382105,29.36961363416287,38.92708434201607
638,12359.297218155341,1735,6453.571440933859,123.59297218155342,64.5357144093386,4085,5023,4347,13455,30.360460795243405,37.33184689706429,32.30769230769231,4522,4838,4095,13455,33.60832404310665,35.956893348197696,30.434782608695656
639,3184.139150943598,1736,3685.7699805065445,31.84139150943598,36.857699805065444,3204,2987,2245,8436,37.98008534850641,35.40777619724988,26.612138454243716,2462,4156,1818,8436,29.184447605500235,49.265054528212424,21.55049786628734
640,8093.125,1737,6310.0,80.93125,63.1,5766,3843,4955,14564,39.59077176599835,26.38698159846196,34.02224663553969,2644,5296,6624,14564,18.15435319967042,36.36363636363637,45.482010436693216
641,6232.12890625,1738,6946.016483516222,62.3212890625,69.46016483516222,2440,2613,2863,7916,30.82364830722587,33.00909550277918,36.167256189994944,2012,3925,1979,7916,25.416877210712478,49.58312278928752,25.0
642,8918.65234375,1739,8627.543859649395,89.1865234375,86.27543859649396,3256,3189,4625,11070,29.41282746160795,28.80758807588076,41.779584462511295,3980,4604,2486,11070,35.95302619692863,41.58988256549232,22.457091237579043
643,6736.666666666673,1741,68016.54314864568,67.36666666666673,680.1654314864568,150,146,1164,1460,10.273972602739725,10.0,79.72602739726027,394,835,231,1460,26.986301369863014,57.1917808219178,15.821917808219176
644,7214.8837209302565,1743,11192.80983916745,72.14883720930257,111.9280983916745,477,560,506,1543,30.913804277381722,36.29293583927414,32.793259883344135,747,574,222,1543,48.41218405703175,37.20025923525599,14.387556707712248
645,6221.093750000127,1744,8168.49514865195,62.21093750000127,81.68495148651951,2600,2945,2469,8014,32.443224357374596,36.74819066633391,30.808584976291492,2499,3492,2023,8014,31.182929872722738,43.57374594459695,25.24332418268031
646,8970.052083333545,1747,7153.131064338677,89.70052083333545,71.53131064338677,4971,5075,3853,13899,35.765162961364126,36.51341823152745,27.721418807108428,3976,5718,4205,13899,28.606374559320813,41.13965033455644,30.253975106122745
647,2924.3382352941962,1748,3781.456043955994,29.243382352941964,37.81456043955994,3322,2878,1139,7339,45.26502248262706,39.21515192805559,15.519825589317346,1706,4105,1528,7339,23.245673797520098,55.93405096062134,20.820275241858564
648,3217.6562500001833,1750,3498.3653846148827,32.176562500001836,34.983653846148826,8542,9342,6478,24362,35.06280272555619,38.346605369017325,26.590591905426486,5712,9663,8987,24362,23.446350874312454,39.6642311797061,36.88941794598144
649,2182.2395833332994,1751,2848.9814814816796,21.822395833332994,28.489814814816796,3068,3638,2420,9126,33.61823361823362,39.864124479509094,26.51764190225729,3318,3627,2181,9126,36.357659434582516,39.743589743589745,23.898750821827743
650,6472.972972972661,1752,7060.143884891915,64.72972972972661,70.60143884891914,1566,1869,2585,6020,26.01328903654485,31.046511627906977,42.94019933554817,2142,2695,1183,6020,35.581395348837205,44.76744186046512,19.651162790697676
651,10324.06451612778,1754,10911.217183770725,103.24064516127781,109.11217183770725,6053,6787,4948,17788,34.02855857881718,38.154935911850686,27.816505509332135,5372,5965,6451,17788,30.200134922419608,33.53384304025185,36.26602203732854
652,1848.760330578555,1755,2593.9393939395627,18.48760330578555,25.93939393939563,2436,2291,1906,6633,36.72546359113523,34.539424091662895,28.73511231720187,1952,3634,1047,6633,29.42861450324137,54.78667269712045,15.784712799638173
653,3817.4479166667547,1756,2884.6153846150896,38.174479166667545,28.846153846150898,5175,5917,3522,14614,35.41124948679348,40.48857260161489,24.100177911591626,4624,4790,5200,14614,31.64089229505953,32.77678938004653,35.58231832489393
654,7168.26171875,1757,6764.322916666599,71.6826171875,67.64322916666599,3339,3306,2397,9042,36.92767086927671,36.56270736562707,26.50962176509622,2791,4391,1860,9042,30.867064808670648,48.56226498562265,20.5706702057067
655,4914.348462664783,1758,4399.862637362278,49.14348462664783,43.998626373622784,4420,4536,3901,12857,34.37815975733064,35.280392004355605,30.341448238313763,2431,5222,5204,12857,18.90798786653185,40.6160068445205,40.476005288947654
656,6741.796875,1761,5120.000000000159,67.41796875,51.200000000001594,3605,3310,2455,9370,38.47385272145144,35.32550693703308,26.200640341515474,2305,4021,3044,9370,24.599786552828178,42.913553895410885,32.48665955176094
657,8000.366032211488,1764,6598.626373625787,80.00366032211488,65.98626373625787,5469,5198,3335,14002,39.05870589915727,37.12326810455649,23.818025996286245,3703,5097,5202,14002,26.446221968290246,36.40194257963148,37.151835452078274
658,6735.578330893436,1765,6960.439560439309,67.35578330893436,69.60439560439309,2965,3717,2856,9538,31.08618158943175,38.97043405326065,29.94338435730761,2754,3945,2839,9538,28.873977773118053,41.3608723002726,29.765149926609354
659,6616.983894582948,1766,5954.288765231119,66.16983894582948,59.542887652311194,3834,3977,2141,9952,38.52491961414791,39.96181672025724,21.513263665594856,2809,3772,3371,9952,28.225482315112536,37.90192926045016,33.872588424437296
660,14372.035139092126,1767,15980.216802167248,143.72035139092125,159.8021680216725,3358,4351,2660,10369,32.384993731314495,41.9616163564471,25.653389912238406,3478,4338,2553,10369,33.54228951682901,41.836242646349696,24.621467836821296
661,7431.944444444442,1768,32097.727272727454,74.31944444444441,320.97727272727457,135,162,2602,2899,4.656778199379096,5.588133839254915,89.75508796136599,998,1678,223,2899,34.42566402207658,57.882028285615725,7.6923076923076925
662,8485.35871156711,1769,9156.593406592821,84.8535871156711,91.56593406592822,3611,3673,2450,9734,37.096774193548384,37.733716868707624,25.16950893774399,2632,4326,2776,9734,27.03924388740497,44.44216149578796,28.518594616807068
663,6062.811127379381,1770,4116.695817551672,60.62811127379381,41.16695817551672,3131,3483,1917,8531,36.701441800492326,40.82757003868245,22.470988160825225,1913,3483,3135,8531,22.4241003399367,40.82757003868245,36.74832962138085
664,5509.443631040081,1771,5779.532967032513,55.09443631040081,57.795329670325124,3951,5055,3289,12295,32.13501423342822,41.11427409516064,26.750711671411143,3204,4553,4538,12295,26.059373729158192,37.03131354209028,36.90931272875152
665,12969.326500732055,1772,12574.932249321995,129.69326500732055,125.74932249321995,3711,4305,2503,10519,35.27901891814811,40.92594353075387,23.795037551098012,3993,4164,2362,10519,37.95988211807206,39.5855119307919,22.45460595113604
666,8712.179016874788,1773,8128.395061727356,87.12179016874788,81.28395061727356,2813,2883,2440,8136,34.574729596853494,35.435103244837755,29.99016715830875,2452,3810,1874,8136,30.137659783677485,46.82890855457227,23.033431661750246
667,4473.020833333387,1774,4864.551286697406,44.73020833333387,48.64551286697406,3623,3527,3108,10258,35.318775589783584,34.38292064729967,30.29830376291675,3289,4076,2893,10258,32.062780269058294,39.734841099629556,28.202378631312147
668,4684.940476190761,1775,3563.960396039487,46.84940476190761,35.63960396039487,5807,4257,1297,11361,51.113458322330786,37.47029310800106,11.416248569668163,4024,3686,3651,11361,35.419417304814715,32.444327083883465,32.13625561130182
669,3891.72767203511,1776,4409.478021977908,38.917276720351104,44.094780219779075,2648,2400,1922,6970,37.99139167862267,34.433285509325685,27.57532281205165,1543,3353,2074,6970,22.137733142037302,48.10616929698709,29.756097560975608
670,11721.834061135674,1777,9897.1311475412,117.21834061135674,98.97131147541201,4205,4068,1916,10189,41.26999705564825,39.92540975561881,18.804593188732944,2668,4447,3074,10189,26.185101580135438,43.645107468838944,30.169790951025615
671,3481.8448023426213,1778,4022.13541666672,34.818448023426214,40.221354166667204,1917,2319,2431,6667,28.75356232188391,34.78326083695815,36.46317684115794,1694,3377,1596,6667,25.408729563521824,50.65246737663117,23.938803059847007
672,2162.2619047619996,1779,2668.7128712870203,21.622619047619995,26.687128712870205,3231,3319,3151,9701,33.30584475827234,34.21296773528502,32.48118750644263,2772,4525,2404,9701,28.574373775899392,46.644675806617876,24.78095041748273
673,9785.358711566678,1780,9022.527472526772,97.85358711566678,90.22527472526772,3650,3828,2925,10403,35.086032875132176,36.79707776602903,28.116889358838797,2779,4836,2788,10403,26.71344804383351,46.48659040661347,26.799961549553014
674,3147.5841874085054,1781,4360.851648351557,31.475841874085052,43.608516483515565,2681,1914,2380,6975,38.437275985663085,27.440860215053764,34.121863799283155,2114,3400,1461,6975,30.308243727598565,48.74551971326165,20.946236559139784
675,14920.036596523441,1782,9581.562515886455,149.20036596523443,95.81562515886455,1248,1175,618,3041,41.039131864518254,38.63860572180204,20.322262413679713,1054,1401,586,3041,34.65965143045051,46.07037158829333,19.269976981256164
676,7255.3125,1783,5941.483516483245,72.553125,59.414835164832446,3671,4361,2754,10786,34.03486000370851,40.43204153532356,25.533098460967924,2845,5108,2833,10786,26.376784720934545,47.35768588911552,26.265529389949936
677,4826.281112737924,1784,2947.6648351648337,48.26281112737924,29.476648351648336,202,200,404,806,25.06203473945409,24.81389578163772,50.12406947890818,103,373,330,806,12.779156327543426,46.27791563275434,40.94292803970223
678,3450.9516837481788,1785,4699.587912087792,34.50951683748179,46.995879120877916,2199,2093,2188,6480,33.93518518518518,32.29938271604939,33.76543209876543,2144,3008,1328,6480,33.086419753086425,46.41975308641975,20.493827160493826
679,4981.54425612046,1786,2082.1752265860105,49.8154425612046,20.821752265860106,3727,3247,1691,8665,43.012117714945184,37.472590882862086,19.51529140219273,2067,2813,3785,8665,23.85458742065782,32.46393537218696,43.681477207155226
680,10333.601756955242,1787,10873.901098900198,103.33601756955242,108.73901098900198,6658,6991,3781,17430,38.19850831899025,40.10900745840505,21.692484222604705,5475,5869,6086,17430,31.411359724612737,33.671830177854275,34.91681009753299
681,6821.010248902258,1788,8452.88461538411,68.21010248902259,84.5288461538411,3734,3843,3436,11013,33.905384545537096,34.895123944429315,31.199491510033596,3276,4928,2809,11013,29.74666303459548,44.74711704349405,25.506219921910468
682,8190.3125,1789,5488.989637305349,81.903125,54.88989637305349,6669,5883,3519,16071,41.49710658950905,36.60630950158671,21.896583908904237,4045,5585,6441,16071,25.169560077157616,34.75203783211997,40.07840209072242
683,4339.521392313291,1790,2884.7206385403415,43.39521392313291,28.847206385403414,3518,3426,2823,9767,36.01924848981263,35.07730111600287,28.9034503941845,1959,3421,4387,9767,20.057335927101462,35.026108323947994,44.91655574895055
684,6296.25,1791,4353.648068669707,62.9625,43.53648068669707,4632,3738,4242,12612,36.726926736441484,29.638439581351093,33.63463368220742,2956,3757,5899,12612,23.437995559784333,29.78908975578814,46.77291468442753
685,6315.625,1792,4331.616595136054,63.15625,43.31616595136054,3815,3399,3653,10867,35.10628508327965,31.27818165086961,33.615533265850736,2715,3407,4745,10867,24.983896199503082,31.3517990245698,43.66430477592712
686,4582.5694444440305,1793,2783.1395348840633,45.8256944444403,27.831395348840633,6807,5436,3321,15564,43.73554356206631,34.926754047802625,21.33770239013107,2609,5567,7388,15564,16.763042919557954,35.768439989719866,47.46851709072218
687,4118.301610541717,1794,4815.934065933689,41.183016105417174,48.15934065933689,3664,3342,3950,10956,33.44286235852501,30.503833515881706,36.053304125593286,2273,5002,3681,10956,20.74662285505659,45.65534866739686,33.59802847754655
688,1610.807291666672,1795,1666.650486166032,16.10807291666672,16.666504861660318,203,252,67,522,38.88888888888889,48.275862068965516,12.835249042145595,207,183,132,522,39.6551724137931,35.05747126436782,25.287356321839084
689,8302.635431918503,1796,5026.315815921473,83.02635431918503,50.263158159214726,4421,3947,2879,11247,39.30825998043923,35.0938027918556,25.597937227705163,2608,3683,4956,11247,23.18840579710145,32.74651018049258,44.065084022405976
690,2857.6041666666974,1797,3826.952380952164,28.576041666666974,38.26952380952164,3233,2502,2210,7945,40.69225928256765,31.491504090623035,27.816236626809314,2375,4034,1536,7945,29.89301447451227,50.77407174323474,19.332913782252987
691,2883.125,1798,3251.1178861786234,28.83125,32.511178861786235,3353,2687,3663,9703,34.55632278676698,27.692466247552304,37.75121096568071,2795,4454,2454,9703,28.80552406472225,45.90332886736061,25.29114706791714
692,7661.171875,1799,4982.894736841699,76.61171875,49.82894736841699,4295,4220,2046,10561,40.668497301391916,39.9583372786668,19.373165419941294,2474,3907,4180,10561,23.42581194962598,36.99460278382729,39.57958526654673
693,4272.035139092274,1800,5697.939560439325,42.720351390922744,56.97939560439325,2612,3109,2369,8090,32.286773794808404,38.4301606922126,29.283065512978983,2424,3761,1905,8090,29.962917181705812,46.48949320148331,23.54758961681088
694,127.67203513909223,1801,182.14285714285714,1.2767203513909222,1.8214285714285714,44,46,29,119,36.97478991596639,38.655462184873954,24.369747899159663,37,42,40,119,31.092436974789916,35.294117647058826,33.61344537815126
695,6098.914616497592,1802,6060.618279570153,60.98914616497592,60.606182795701535,2831,2600,3084,8515,33.24721080446271,30.53435114503817,36.21843805049912,3331,3240,1944,8515,39.11920140927774,38.05049911920141,22.830299471520846
696,2333.419421487665,1803,2165.719696969892,23.334194214876653,21.65719696969892,6092,5842,3712,15646,38.93646938514636,37.33861689888789,23.72491371596574,3072,4958,7616,15646,19.634411351144063,31.68861050747795,48.67697814137799
697,3635.61643835608,1804,2277.2545090180147,36.3561643835608,22.772545090180145,3988,3622,2132,9742,40.93615274071033,37.17922397864915,21.884623280640525,2025,3809,3908,9742,20.786286183535207,39.098747690412644,40.114966126052146
698,4342.093704246043,1805,4309.340659340574,43.42093704246043,43.093406593405746,2726,2893,2456,8075,33.758513931888544,35.8266253869969,30.414860681114554,1994,4139,1942,8075,24.69349845201238,51.25696594427245,24.04953560371517
699,10303.074670571397,1806,8235.851648351012,103.03074670571397,82.35851648351012,5734,5776,2749,14259,40.213198681534465,40.50774949154919,19.279051826916334,4155,5406,4698,14259,29.139490847885547,37.91289711760993,32.94761203450452
700,3237.174479166666,1807,3529.5192301130123,32.37174479166666,35.29519230113012,99,147,140,386,25.647668393782386,38.082901554404145,36.26943005181347,146,207,33,386,37.82383419689119,53.626943005181346,8.549222797927461
701,11671.5959004397,1808,8002.747252746718,116.71595900439699,80.02747252746718,5852,8904,3411,18167,32.212252986183735,49.01194473495899,18.775802278857267,5412,5509,7246,18167,29.790279077448123,30.3242142346012,39.88550668795068
702,9924.444444444442,1810,43095.535714285485,99.24444444444441,430.95535714285484,176,198,2940,3314,5.310802655401328,5.974652987326494,88.71454435727217,585,2469,260,3314,17.652383826191915,74.50211225105613,7.845503922751962
703,6198.975109809937,1811,5953.983516483293,61.98975109809937,59.53983516483293,1847,2246,1572,5665,32.60370697263901,39.64695498676081,27.749338040600176,1507,2852,1306,5665,26.601941747572816,50.34421888790821,23.05383936451898
704,2589.6778916544763,1812,4439.148351648315,25.89677891654476,44.39148351648315,1836,1694,2219,5749,31.93598886762915,29.46599408592799,38.59801704644286,1767,3054,928,5749,30.73578013567577,53.12228213602366,16.141937728300572
705,9032.869692533095,1813,9232.967032966162,90.32869692533095,92.32967032966162,3308,4044,3015,10367,31.908941834667697,39.008392013118545,29.082666152213754,2852,4917,2598,10367,27.51036944149706,47.42934310793866,25.06028745056429
706,3865.4465592972324,1814,4785.989010988878,38.65446559297232,47.85989010988878,2279,2051,1479,5809,39.23222585642968,35.30728180409709,25.460492339473227,1892,2856,1061,5809,32.570149767602,49.16508865553452,18.264761576863485
707,4953.587115666374,1815,5572.2527472525535,49.535871156663745,55.722527472525535,2158,2861,1693,6712,32.151370679380214,42.62514898688916,25.22348033373063,1763,3470,1479,6712,26.266388557806913,51.6984505363528,22.035160905840286
708,6257.174231332683,1816,6874.862637362448,62.57174231332683,68.74862637362449,2351,2114,1599,6064,38.769788918205805,34.861477572559366,26.368733509234826,2113,2776,1175,6064,34.84498680738786,45.77836411609499,19.37664907651715
709,4952.562225476105,1817,6411.263736263497,49.525622254761046,64.11263736263497,2600,2537,1764,6901,37.67569917403275,36.762788001738876,25.561512824228373,1967,3729,1205,6901,28.503115490508623,54.03564700768004,17.461237501811333
710,5385.724743777701,1818,6421.291208790944,53.85724743777701,64.21291208790944,2124,3077,2144,7345,28.91763104152485,41.89244383934649,29.189925119128656,2140,3730,1475,7345,29.1354663036079,50.78284547311096,20.081688223281144
711,8602.378774016575,1819,6500.340134493274,86.02378774016576,65.00340134493274,2020,2295,2041,6356,31.780994336060413,36.10761485210824,32.11139081183134,2271,2748,1337,6356,35.730018879798614,43.23473882945248,21.035242290748897
712,3692.0204978038055,1820,4662.362637362473,36.92020497803806,46.62362637362473,2414,2147,1506,6067,39.78902258117686,35.388165485412884,24.822811933410254,2012,2789,1266,6067,33.163013021262564,45.97000164826108,20.866985330476346
713,6259.956076134992,1821,7170.329670329401,62.59956076134992,71.70329670329401,2294,2543,2162,6999,32.77611087298185,36.333761965995144,30.890127161023003,2481,2980,1538,6999,35.44792113159023,42.577511073010434,21.974567795399345
714,4827.672035139329,1822,5124.862637362473,48.27672035139329,51.24862637362473,2306,2629,1877,6812,33.852025836758656,38.5936582501468,27.55431591309454,1648,3822,1342,6812,24.192601291837935,56.10687022900763,19.700528479154432
715,3927.0863836017465,1823,4722.664835164702,39.27086383601747,47.226648351647015,2677,2282,1842,6801,39.3618585502132,33.55388913395089,27.084252315835904,2115,3407,1279,6801,31.09836788707543,50.09557418026761,18.806057932656962
716,6260.614934114452,1824,6318.5439560436835,62.606149341144516,63.18543956043683,3093,3246,1905,8244,37.51819505094614,39.37409024745269,23.107714701601164,1886,3986,2372,8244,22.87724405628336,48.35031538088307,28.772440562833573
717,7246.064516128407,1826,7752.8639618142315,72.46064516128408,77.52863961814232,5003,4278,3868,13149,38.04852080006084,32.534793520419804,29.416685679519354,3313,4830,5006,13149,25.195832382690696,36.732831394022355,38.07133622328694
718,6286.458333333022,1827,4820.226130653278,62.864583333330216,48.20226130653278,3076,3231,2661,8968,34.29973238180196,36.028099910793934,29.6721677074041,2616,2800,3552,8968,29.170383586083855,31.222123104371097,39.60749330954505
719,7728.91654465645,1828,7148.626373625594,77.2891654465645,71.48626373625594,4616,4723,3722,13061,35.34185743817472,36.161090268738995,28.497052293086288,3618,4985,4458,13061,27.70078860730419,38.16706224638236,34.13214914631345
720,5464.485294117896,1829,6031.318681318422,54.64485294117896,60.31318681318422,3189,3748,2321,9258,34.44588464031108,40.483905811190326,25.070209548498596,2763,4357,2138,9258,29.84445884640311,47.06200043205876,23.09354072153813
721,10455.417276720798,1830,6181.868131867728,104.55417276720799,61.81868131867728,5173,5257,2631,13061,39.60646198606538,40.24959803996631,20.1439399739683,3525,3957,5579,13061,26.988745119056734,30.29630196769007,42.71495291325319
722,4313.8125,1831,4639.651162790863,43.138125,46.39651162790863,4054,4236,3150,11440,35.43706293706293,37.02797202797203,27.534965034965037,2566,4365,4509,11440,22.43006993006993,38.15559440559441,39.41433566433567
723,5549.121522693999,1832,3295.1923076923104,55.49121522693999,32.9519230769231,127,148,499,774,16.40826873385013,19.12144702842377,64.47028423772609,133,362,279,774,17.183462532299743,46.770025839793284,36.04651162790697
724,8971.547420963474,1833,6613.7557959806745,89.71547420963473,66.13755795980674,8742,6819,3820,19381,45.10603168051184,35.183943036995,19.710025282493163,5951,4835,8595,19381,30.705329962334243,24.94711315205614,44.34755688560962
725,10448.975109809822,1834,5575.203252032996,104.48975109809822,55.752032520329955,6842,7347,3771,17960,38.09576837416481,40.9075723830735,20.99665924276169,4198,5895,7867,17960,23.374164810690424,32.82293986636971,43.80289532293987
726,9596.925329429569,1835,8529.39560439459,95.96925329429568,85.2939560439459,6402,7502,4101,18005,35.55678978061649,41.66620383226881,22.77700638711469,5616,6502,5887,18005,31.1913357400722,36.112191058039436,32.69647320188837
727,3158.125915080541,1836,4329.395604395519,31.58125915080541,43.293956043955184,2033,1827,1324,5184,39.21682098765432,35.24305555555556,25.540123456790127,1294,2952,938,5184,24.96141975308642,56.94444444444444,18.094135802469136
728,4295.312499999927,1837,4356.263736264109,42.953124999999275,43.56263736264109,3913,3828,2905,10646,36.755588953597595,35.957167011083975,27.28724403531843,2802,4489,3355,10646,26.31974450497839,42.16607176404283,31.514183730978772
729,8526.720351391297,1838,6040.247252746934,85.26720351391297,60.402472527469335,4738,5638,2950,13326,35.554555005252894,42.30826954825154,22.137175446495572,4194,4955,4177,13326,31.47230977037371,37.18295062284256,31.344739606783733
